一: b
丁: bm
七: bn
万: bue
丈: bec
三: bbb
上: dbb
下: bda
不: beda
与: bxb
丐: bdbx
丑: zdbb
专: bb5a
且: dzbbb
丕: bedab
世: bddb2
丘: edbdb
丙: bduea
业: ddaeb
丛: eaecb
东: b3mea
丝: 3333b
丞: hmhecb
丢: ebdb3a
两: bdueaea
严: bddaebe
丧: bdaebjec
个: ecd
丫: aed
中: dzbd
丰: bbbd
串: dzbdzbd
临: ddebadzdb
丸: ewa
丹: euab
为: aeua
主: abbdb
丽: bduadua
举: aaebecbbd
乂: ec
乃: re
久: ehc
么: e3a
义: aec
之: ahc
乌: euxb
乍: ebdbb
乎: eaebm
乏: eahc
乐: e2mea
乒: edbdbe
乓: edbdba
乔: ebeced
乖: ebddbfen
乘: ebddbfenec
乙: w
乜: un
九: ew
乞: ebw
也: udn
习: uaf
乡: 33e
书: zuda
乩: dbdzbn
买: haabea
乱: ebddzbn
乳: eaaehmfn
乾: bddzbbbdebw
了: hm
予: hahm
争: ehzbbm
事: bdzbzbbm
二: bb
亍: bbm
于: bbm
亏: bbx
云: bb3a
互: b3hb
亓: bbed
五: bdzb
井: bbed
亘: bdzbbb
亚: bddaeb
些: dbdfenbb
亟: hmdzbhab
亡: ab2
亢: abew
交: abeaec
亥: ab3eea
亦: abemea
产: abaebe
亨: abdzbhm
亩: abdzbdb
享: abdzbhmb
京: abdzbmea
亭: abdzbahbm
亮: abdzbahew
亲: abaebbmea
亳: abdzbahebn
亵: abbmfewaejec
亶: abdzdzbbdzbbb
亸: abdzbhmfaedzbbbd
人: ec
亿: edw
什: edbd
仁: edbb
仂: edue
仃: edbm
仄: beec
仅: edhc
仆: edda
仇: edew
仉: edew
今: ecah
介: eced
仍: edre
从: eaec
仑: ecen
仓: ecun
仔: edhmb
仕: edbdb
他: edudn
仗: edbec
付: edbma
仙: edd2d
仞: eduea
仟: edebd
仡: edebw
代: edboa
令: ecaha
以: jaea
仨: edbbb
仪: edaec
仫: ede3a
们: edadu
仰: edejud
仲: eddzbd
仳: edbjen
仵: edebbd
件: edebbd
价: edeced
任: edebdb
份: edecue
仿: edabue
企: ecdbdb
伉: edabew
伊: edzbbe
伋: ede6c
伍: edbdzb
伎: edbdhc
伏: edbeca
伐: edboea
休: edbdec
众: eceaec
优: edbena
伙: edaeec
会: ecbb3a
伛: edbea2
伞: ecaebd
伟: edbbud
传: edbb5a
伢: edb3me
伤: edebue
伥: edebjc
伦: edecen
伧: edecun
伪: edaeua
伫: edaahb
伯: ededzbb
估: edbddzb
伴: edaebbd
伶: edecaha
伸: eddzbbd
伺: edubdzb
似: edjaea
伽: eduedzb
伾: edbedab
佃: eddzbdb
但: eddzbbb
位: edabaeb
低: edejboa
住: edabbdb
佐: edbebdb
佑: edbedzb
体: edbdecb
何: edbdzbm
佗: edaahen
佘: ecbbmea
余: ecbbmea
佚: edebbec
佛: edzbxed
作: edebdbb
佝: edeudzb
佞: edbbieb
佟: edehcaa
你: edehmea
佣: edeubbd
佤: edbjwa
佥: ecbaaeb
佩: edewbdud
佬: edbdbeen
佯: edaebbbd
佰: edbedzbb
佳: edbdbbdb
佴: edbddbbb
佶: edbdbdzb
佻: edeafnea
佼: edabeaec
佾: edecdubb
使: edbdzbec
侃: eddzbedn
侄: edb3abdb
侈: edehaeha
侉: edbecbbx
例: edbehadm
侍: edbdbbma
侏: edebbdec
侑: edbedubb
侔: ed3aebbd
侗: eddubdzb
供: edbddbea
依: edabejec
侠: edbaebec
侣: eddzbdzb
侥: edboeben
侦: eddbdzea
侧: eddzeadm
侨: edebeced
侩: edecbb3a
侪: edabeced
侬: edahejec
侮: edeb2uaba
侯: edzbebbec
侵: edzbbahhc
便: edbdzbbec
促: eddzbdbec
俄: edebmfoea
俅: edbmafeca
俊: ed3aeaehc
俎: eaeadzbbb
俏: eddaedubb
俐: edebdeadm
俑: edhadubbd
俗: edeaecdzb
俘: edeaaehmb
俚: eddzbbdbb
俜: eddzbdbbx
保: eddzbbdec
俞: ecbdubbdm
俟: ed3aebbec
信: edabbbdzb
俣: eddzbbbec
俦: edbbbebma
俨: edbddaebe
俩: edbdueaea
俪: edbduadua
俭: edecbaaeb
修: eddehceee
俯: edabeedbma
俱: eddzbbbbea
俳: eddbbbdbbb
俵: edbbdbejec
俶: eddbbmeahc
俸: edbbbecbbd
俺: edbecdzbbn
俾: ededzbbebd
倌: edaahdzbzb
倍: edabaebdzb
倏: eddehcbeaa
倒: edb3abdfdm
倓: edaeeaaeec
倔: edzbe2dd2d
倘: eddaedudzb
候: eddzbebbec
倚: edbeabdzbm
倜: edeubdbdzb
倞: edabdzbmea
借: edbddbdzbb
倡: eddzbbdzbb
倥: edaaheabdb
倦: edaebbecun
倨: edzbebddzb
倩: edbbdbdubb
倪: ededbzbben
倬: eddbdzbbbd
倭: edebdecieb
债: edbbdbdzea
倻: edbddbbf7d
值: edbddzbbbb
倾: edbjbedzea
偃: edbdzbbieb2
假: edzbdbbzbhc
偈: eddzbbeuea2
偌: edbddbedzb
偎: eddzbdbbjec
偏: edazbedubdd
偕: edbjenedzbb
做: edbddzbebec
停: edabdzbahbm
健: edzbbbbd6c
偬: edeueeaaoaa
偲: eddzbdbaoaa
偶: eddzbbdudfa
偷: edecbdubbdm
偻: edaebdecieb
偾: edbdbdddzea
偿: eddaeahbb3a
傀: ededzbben3a
傅: edbdzbbdabma
傈: edbdzddbbdec
傍: edabaeahabue
傣: edbbbecmafea
傥: eddaeahdzben
傧: edaahedbdbea
储: edakbdbedzbb
傩: edhaedabbbdb
催: edd2dedabbbdb
傲: edbbdbueebec
傻: ededzeabeaehc
僇: edzafzafeceee
像: edehdzbeleeec
僖: edbdbdzbaebdzb
僚: edbecaedzbbmea
僦: edabdzbmeabena
僧: edaedzdaebdzbb
僬: ededabbbdbaaaa
僭: edb3ejb3endzbb
僮: edabaebdzbbdbb
僰: bdzdeabdzdeaec
僳: edbdzddbaebdec
僵: edbdzbdbbdzbdbb
僻: edzbedzbabaebbd
儆: edbddeudzbebec
儇: eddzddbbdzbejec
儋: edehbeeaabbbdzb
儒: edbahdaaaabedudd
儡: eddzbdbdzbdbdzbdb
儿: en
兀: ben
允: 3aen
元: bben
兄: dzben
充: ab3aen
兆: eafnea
先: ebdben
光: daeben
克: bddzben
免: ehdzben
兑: aedzben
兔: ehdzbena
兕: dqdzben
兖: abea3aen
党: daeahdzben
兜: edzbbejzben
兢: bddzbejbddzben
入: ec
全: ecbbdb
八: ec
公: ec3a
六: abea
兮: ecbx
兰: aebbb
共: bddbea
关: aebbec
兴: aaebea
兵: edbdbea
其: bddbbbea
具: dzbbbbea
典: dzbddbea
兹: aeb33a33a
养: aebbbeced
兼: aebzbbddec
兽: aedzbdbbdzb
冀: dbfendzbdbbddbea
冁: aedzbbbdzbebddbjec
内: duea
冈: duea
冉: dudbb
册: eueub
再: bdudbb
冒: dzbbdzbbb
冕: dzbbehdzben
冗: ahew
写: ahbxb
军: ahb3bd
农: ahejec
冠: ahbbenbma
冢: ahbeleeaec
冤: ahehdzbena
冥: ahdzbbabea
冬: ehcaa
冯: afzxb
冰: afmhec
冱: afb3hb
冲: afdzbd
决: afzbec
况: afdzben
冶: af3adzb
冷: afecaha
冻: afb3mea
冼: afebdben
冽: afbehadm
净: afehzbbm
凄: afbzbbdieb
准: afedabbbdb
凇: afbdeaec3a
凉: afabdzbmea
凋: afeubdbdzb
凌: afbdbeaehc
减: afbebdzboea
凑: afbbbecbbea
凛: afabdzdzbbbbmea
凝: afenebbeahahdbec
几: ew
凡: ewa
凤: ewha
凫: euaxew
凭: edebdbew
凯: d2dzbjew
凰: ewedzbbbbdb
凳: haeecbdzbaebew
凶: ea2d
凸: dbdrb
凹: dqdzb
出: 2dd2d
击: bbd2d
凼: mhea2d
函: hmafea2d
凿: ddaebaebbd2d
刀: ue
刁: uf
刃: uea
分: ecue
切: bjue
刈: eadm
刊: bbddm
刍: ehzbb
刎: eueedm
刑: bbeddm
划: boeadm
刖: eubbdm
列: behadm
刘: abeadm
则: dzeadm
刚: dueadm
创: eaundm
初: ahdeaue
删: eueubdm
判: aebbedm
刨: euzbndm
利: ebdeadm
别: dzbuedm
刭: habdfdm
刮: ebddzbdm
到: b3abdfdm
刳: beabbxdm
制: ebbduddm
刷: zbeduddm
券: aebbecue
刹: eabmeadm
刺: bdudeadm
刻: ab3eeadm
刽: eabb3adm
刿: d2dehadm
剀: d2dzbjdm
剁: eqbdeadm
剂: abeaeddm
剃: aezbxdedm
剅: bdzbaefdm
削: daedubbdm
剌: bdzbdeadm
前: aebdubbdm
剐: dzbdueadm
剑: eabaaefdm
剔: dzbbeueedm
剕: dbbbdbbbdm
剖: abaebdzbdm
剜: aahehaujdm
剞: beabdzbmdm
剟: hahahahadm
剡: aeeaaeeadm
剥: zbbmafeadm
剧: zbebddzbdm
剩: ebddbfeneadm
剪: aebdubbdmue
副: bdzbdzbdbdm
割: aahbbbddzbdm
剽: bdzddbbbmeadm
剿: iiidzbbbdeadm
劁: edabbbdbaaaadm
劂: beaeb2deeheadm
劈: zbedzbabaebbdue
劐: bddedabbbdbhadm
劓: edzbbbdzbdbbeddm
力: ue
劝: haue
办: ueaa
功: bdfue
加: uedzb
务: ehcue
劢: bueue
劣: deaeue
动: bb3aue
助: dzbbfue
努: iebhcue
劫: bdb3aue
劬: eudzbue
劭: uedzbue
励: bebueue
劲: habdfue
劳: bddahue
劾: ab3eeaue
势: bmfewaue
勃: bdahhmfue
勇: hadzbbdue
勉: ehdzbenue
勋: dzbdzeaue
勍: abdzbmeaue
勐: hmbdzddfue
勒: bddbdzbbdue
勖: dzbbdzbbbue
勘: bddbbbea2ue
勚: bddb2dzeaue
募: bdddzbbbecue
勤: bddbdzbbbdfue
勰: ueueuedzbdbaoaa
勺: eua
勾: eu3a
勿: euee
匀: euaf
包: euzbn
匆: eueea
匈: euea2d
匍: eubdubbda
匏: beabbxeuzbn
匐: eubdzbdzbdb
匕: en
化: eden
北: dbfen
匙: dzbbbdbecen
匜: budn2
匝: bdud2
匠: beebd2
匡: bbbdb2
匣: bdzbbd2
匦: bb3dfew2
匪: bdbbbdbbb2
匮: bdzbdbdzea2
匹: ben2
区: bea2
医: bebbea2
匾: bazbedubdd2
匿: bbddbedzb2
十: bd
千: ebd
卅: bedd
升: ebed
午: ebbd
卉: bdbed
半: aebbd
华: edenbd
协: bdueaa
卑: edzbbebd
卒: abeaeabd
卓: dbdzbbbd
单: aedzbbbd
卖: bdhaabea
南: bdduaebbd
博: bdbdzbbdabma
卜: da
卞: abda
卟: dzbda
占: dbdzb
卡: dbbda
卢: dbzbe
卣: dbdzzbb
卤: dbdzeab
卦: bdbbdfda
卧: bdzbd2da
卫: udb
卮: eebun
卯: ejeud
印: ejbud
危: ehbeun
即: zbbjaud
却: bdb3aud
卵: ejaeuda
卷: aebbecun
卸: ebbdbdfud
卺: hmhecbun
卿: ejezbbjaud
厂: be
厄: beun
厅: bebm
历: beue
厉: bebue
压: bebdba
厌: bebeca
厍: beb3bd
厕: bedzeadm
厘: bedzbbdbb
厚: bedzbbhmb
厝: bebddbdzbb
原: beedzbbmea
厢: bebdeadzbbb
厣: bebecadzbbd
厥: beaeb2deehec
厦: bebedzbbbehc
厨: bebdzbaefbma
厩: bezbbjab3en
厮: bebddbbbeaeebd
去: bdb3a
厾: wbdb3a
县: dzbbb3a
叁: 3abecbbb
参: 3abeceee
又: hc
叉: hca
及: e6c
友: behc
双: hahc
反: eehc
发: 3ehca
叔: dbbmeahc
取: bddbbfhc
受: eaaeahhc
变: abddeahc
叙: eabbmeahc
叛: aebbeeehc
叟: edbzbbdhc
叠: hahahaahdzbbb
口: dzb
古: bddzb
句: eudzb
另: dzbue
叨: dzbue
叩: dzbud
只: dzbea
叫: dzbjd
召: uedzb
叭: dzbec
叮: dzbbm
可: bdzbm
台: 3adzb
叱: dzben
史: dzbec
右: bedzb
叵: bdzb2
叶: dzbbd
号: dzbbx
司: ubdzb
叹: dzbhc
叻: dzbue
叼: dzbuf
叽: dzbew
吁: dzbbbm
吃: dzbebw
各: ehcdzb
吆: dzb33a
合: ecbdzb
吉: bdbdzb
吊: dzbdud
同: dubdzb
名: ehadzb
后: eebdzb
吏: bdzbec
吐: dzbbdb
向: edudzb
吓: dzbbda
吕: dzbdzb
吗: dzbzxb
君: zbbedzb
吝: abecdzb
吞: bbecdzb
吟: dzbecah
吠: dzbbeca
吡: dzbbjen
吣: dzbaoaa
否: bedadzb
吧: dzbzdbn
吨: dzbb2dn
吩: dzbecue
含: ecahdzb
听: dzbeebd
吭: dzbabew
吮: dzb3aen
启: azbedzb
吱: dzbbdhc
吲: dzbzbxd
吴: dzbbbec
吵: dzbdeae
吸: dzbe6c
吹: dzbehec
吻: dzbeuee
吼: dzbhmfn
吾: bdzbdzb
呀: dzbb3me
呃: dzbbeun
呆: dzbbdec
呈: dzbbbdb
告: ebdbdzb
呋: dzbbbec
呐: dzbduea
呓: dzbbddw
呔: dzbbeca
呕: dzbbea2
呖: dzbbeue
呗: dzbdzea
员: dzbdzea
呙: dzbduea
呛: dzbecun
呜: dzbeuxb
呢: dzbzbeen
呤: dzbecaha
呦: dzb33aue
周: eubdbdzb
呱: dzbeejac
呲: dzbdbdfen
味: dzbbbdec
呵: dzbbdzbm
呶: dzbiebhc
呷: dzbdzbbd
呸: dzbbedab
呻: dzbdzbbd
呼: dzbeaebm
命: ecbdzbud
咀: dzbdzbbb
咂: dzbbdud2
咄: dzb2dd2d
咆: dzbeuzbn
咋: dzbebdbb
和: ebdeadzb
咎: ehcdadzb
咏: dzbauhec
咐: dzbedbma
咒: dzbdzbew
咔: dzbdbbda
咕: dzbbddzb
咖: dzbuedzb
咙: dzbbenea
咚: dzbehcaa
咛: dzbaahbm
咝: dzb3333b
咣: dzbdaeben
咤: dzbaahebn
咦: dzbbzbxec
咧: dzbbehadm
咨: afehecdzb
咩: dzbaebbbd
咪: dzbaebdec
咫: zbecdzbea
咬: dzbabeaec
咭: dzbbdbdzb
咯: dzbehcdzb
咱: dzbedzbbb
咳: dzbab3eea
咴: dzbbeaeec
咸: bebdzboea
咻: dzbedbdec
咽: dzbdzbeab
咿: dzbedzbbe
哀: abdzbejec
品: dzbdzbdzb
哂: dzbbdze2b
哄: dzbbddbea
哆: dzbehaeha
哇: dzbbdbbdb
哈: dzbecbdzb
哉: bdbdzboea
哌: dzbeeejec
响: dzbedudzb
哎: dzbbddec
哏: dzbzbbjec
哐: dzbbbbdb2
哑: dzbbddaeb
哓: dzbboeben
哔: dzbbjenbd
哕: dzbd2deha
哗: dzbedenbd
哙: dzbecbb3a
哚: dzbeqbdec
哝: dzbahejec
哞: dzb3aebbd
哟: dzb33feua
哥: bdzbdbdzbm
哦: dzbebmfoea
哧: dzbbdbemea
哨: dzbdaedubb
哩: dzbdzbbdbb
哪: dzbubberd
哭: dzbdzbbeca
哮: dzbbdbehmb
哲: bmfeebddzb
哳: dzbbmfeebd
哺: dzbbdubbda
哼: dzbabdzbhm
哽: dzbbdzbbec
哿: uedzbbdzbm
唁: dzbabbbdzb
唆: dzb3aeaehc
唇: bebbjecdzb
唉: dzb3aebbec
唏: dzbeabedud
唐: abezbbddzb
唑: dzbeaeabdb
唔: dzbbdzbdzb
唛: dzbbbdbehc
唝: dzbbdbdzea
唠: dzbbddahue
唢: dzbdaedzea
唣: dzbedzbbbn
唤: dzbehdzbec
唧: dzbzbbjaud
唪: dzbbbbecbbd
唬: dzbdbhebnew
售: edabbbdbdzb
唯: dzbedabbbdb
唱: dzbdzbbdzbb
唳: dzbazbebeca
唷: dzbab3adubb
唼: dzbabaebieb
唾: dzbebdbddbb
唿: dzbeueeaoaa
啁: dzbeubdbdzb
啃: dzbdbdbdubb
啄: dzbbeleeaec
商: abaedueadzb
啉: dzbbdeabdec
啊: dzbrdbdzbm
啐: dzbabeaeabd
啕: dzbeuebbd2d
啖: dzbaeeaaeec
啜: dzbhahahahc
啡: dzbdbbbdbbb
啤: dzbedzbbebd
啥: dzbecbbddzb
啦: dzbbmfabaeb
啧: dzbbbdbdzea
啪: dzbbmfedzbb
啬: bdaebdzdzbb
啭: dzbb3dfbb5a
啮: dzbdbdbea2d
啰: dzbdzddbeha
啴: dzbaedzbbbd
啵: dzbaafhedhc
啶: dzbaahbdbec
啷: dzbazbbjard
啸: dzbzbbdedea
啻: abaeahduddzb
啼: dzbabaeahdud
啾: dzbebdeaaeec
喀: dzbaahehcdzb
喁: dzbdzbbdudfa
喂: dzbdzbdbbjec
喃: dzbbdduaebbd
善: aebbbdaebdzb
喇: dzbbdzbdeadm
喈: dzbbjenedzbb
喉: dzbedzbebbec
喊: dzbbebdzboea
喋: dzbbddb2bdec
喏: dzbbddbedzb
喑: dzbabaebdzbb
喔: dzbzbeb3abdb
喘: dzbd2dbedudd
喙: dzb3hbeleeec
喜: bdbdzbaebdzb
喝: dzbdzbbeuea2
喟: dzbdzbdbdubb
喤: dzbedzbbbbdb
喧: dzbaahbdzbbb
喱: dzbbedzbbdbb
喳: dzbbdecdzbbb
喵: dzbbdddzbdb
喷: dzbbdbdddzea
喹: dzbbecbdbbdb
喻: dzbecbdubbdm
喽: dzbaebdecieb
喾: aaeahebdbdzb
嗄: dzbbedzbbbehc
嗅: dzbedzbbbbeca
嗉: dzbbbdb33amea
嗌: dzbaebeadzddb
嗍: dzbaeb2deeubb
嗑: dzbbdb3adzddb
嗒: dzbbddecbdzb
嗓: dzbhahahabdec
嗔: dzbbddzbbbbea
嗖: dzbedbzbbdhc
嗜: dzbbdbeendzbb
嗝: dzbbdzbduaebd
嗞: dzbaeb33a33a
嗟: dzbaebbbebdb
嗡: dzbec3auafuaf
嗣: dzbdubddubdzb
嗤: dzb2ddbdzbdba
嗥: dzbedzbbbecbd
嗦: dzbbdah33amea
嗨: dzbaafeb2uaba
嗪: dzbbbbecebdea
嗫: dzbbddbbbhahc
嗬: dzbbddedbdzbm
嗯: dzbdzbeabaoaa
嗲: dzbeaecehaeha
嗳: dzbeaaeahbehc
嗵: dzbhadubbda6c
嗷: dzbbbdbueebec
嗽: dzbbdzbdeaehec
嗾: dzbabueebebbec
嘀: dzbabaedubddzb
嘁: dzbbedbbmeaoea
嘈: dzbbdzbddbdzbb
嘉: bdbdzbaebuedzb
嘌: dzbbdzddbbbmea
嘎: dzbbedzbbbboea
嘏: bddzbzbdbbzbhc
嘘: dzbdbhebnddaeb
嘚: dzbeeddzbbbbma
嘛: dzbabebdeabdec
嘞: dzbbddbdzbbdue
嘟: dzbbdbedzbbrd
嘡: dzbdaeahdzbbdb
嘣: dzbd2deubbeubb
嘤: dzbdzeadzeaieb
嘧: dzbaahaoaead2d
嘬: dzbdzbbbddbbfhc
嘭: dzbbdbdzbaefeee
嘱: dzbzbeedzbdudfa
嘲: dzbbddzbbbdeubb
嘴: dzbdbdfeneheubbd
嘶: dzbbddbbbeaeebd
嘹: dzbbecaedzbbmea
嘻: dzbbdbdzbaebdzb
嘿: dzbdzaebdbbaaaa
噀: dzbzbnzbnbddbea
噌: dzbaedzdaebdzbb
噍: dzbedabbbdbaaaa
噎: dzbbdbahbdzbaeb
噔: dzbhaeecbdzbaeb
噗: dzbddaebaebbbec
噙: dzbecabea2ddu3a
噜: dzbehdzbdbbdzbb
噢: dzbedzaebdeabec
噤: dzbbdeabdecbbmea
器: dzbdzbbecadzbdzb
噩: bddzbdzbbdzbdzbb
噪: dzbdzbdzbdzbbdec
噫: dzbabaebdzbbaoaa
噬: dzbebaebabdeaeab
噱: dzbdbhebnbeleeec
噶: dzbbdddzbbeuea2
噻: dzbaahbbddbecbdb
噼: dzbzbedzbabaebbd
嚄: dzbbddedabbbdbhc
嚅: dzbbahdaaaabedudd
嚆: dzbbddabdzbdudzb
嚎: dzbabdzbahbeleeec
嚏: dzbbdahdzbdbhdbec
嚓: dzbaahehaahcbbmea
嚚: dzbdzbbdzbd2dzbdzb
嚣: dzbdzbbedzeadzbdzb
嚯: dzbbahdaaaaedabbbdb
嚷: dzbabdzbdzbbbddbejec
嚼: dzbeaaedzddbzbbjabma
囊: bdzbdahdzbdzbbbddbejec
囔: dzbbdzbdahdzbdzbbbddbejec
囚: dzeab
四: dze2b
囝: dzhmbb
回: dzdzbb
囟: edzeab
因: dzbeab
囡: dziebb
团: dzbmeb
囤: dzb2dnb
囫: dzeueeb
园: dzbbenb
困: dzbdeab
囱: edzehab
围: dzbbudb
囵: dzecenb
囹: dzecahab
固: dzbddzbb
国: dzbbdbab
图: dzehcaab
囿: dzbedubbb
圃: dzbdubbdab
圄: dzbdzbdzbb
圆: dzdzbdzeab
圈: dzaebbecunb
圉: dzbdbaebbdb
圊: dzbbdbdubbb
圜: dzdzddbbdzbejeab
土: bdb
圣: hcbdb
在: bedbdb
圩: bdfbbm
圪: bdfebw
圬: bdfbbx
圭: bdbbdb
圮: bdfzbn
圯: bdfzbn
地: bdfudn
圳: bdfedd
圹: bdfabe
场: bdfree
圻: bdfeebd
圾: bdfe6c
址: bdfdbdb
坂: bdfeehc
均: bdfeuaf
坊: bdfabue
坌: ecuebdb
坍: bdfeuab
坎: bdfehec
坏: bdfbeda
坐: eaeabdb
坑: bdfabew
块: bdfzbec
坚: ddhcbdb
坛: bdfbb3a
坜: bdfbeue
坝: bdfdzea
坞: bdfeuxb
坟: bdfabec
坠: rdecbdb
坡: bdfhedhc
坤: bdfdzbbd
坦: bdfdzbbb
坨: bdfaahen
坩: bdfbddbb
坪: bdfbaebd
坫: bdfdbdzb
坭: bdfzbeen
坯: bdfbedab
坳: bdf33aue
坷: bdfbdzbm
坻: bdfejboa
坼: bdfeebda
垂: ebdbddbb
垃: bdfabaeb
垄: beneabdb
垅: bdfbenea
垆: bdfdbzbe
型: bbeddmbdb
垌: bdfdubdzb
垍: bdfedzbbb
垒: 3a3a3abdb
垓: bdfab3eea
垛: bdfeqbdec
垞: bdfaahebn
垟: bdfaebbbd
垠: bdfzbbjec
垡: edboeabdb
垢: bdfeebdzb
垣: bdfbdzbbb
垤: bdfb3abdb
垦: zbbjecbdb
垧: bdfedudzb
垩: bddaebbdb
垫: bmfewabdb
垭: bdfbddaeb
垮: bdfbecbbx
垯: bdfbeaa6c
垱: bdfdaezbb
垲: bdfd2dzbn
垸: bdfaahbben
埂: bdfbdzbbec
埃: bdf3aebbec
埋: bdfdzbbdbb
城: bdfbeuoea
埏: bdfedb26c
埒: bdfeaaebma
埔: bdfbdubbda
埕: bdfdzbbbdb
埘: bdfdzbbbma
埙: bdfdzbdzea
埚: bdfdzbduea
埝: bdfecahaoaa
域: bdfbdzbfoea
埠: bdfedzbzbbd
埭: bdfzbbmafec
埯: bdfbecdzbbn
埴: bdfbddzbbbb
埸: bdfdzbbeuee
培: bdfabaebdzb
基: bddbbbecbdb
埼: bdfbeabdzbm
埽: bdfzbbahdud
堂: daeahdzbbdb
堆: bdfedabbbdb
堇: bddbdzbbbdb
堉: bdfab3adubb
堋: bdfeubbeubb
堌: bdfdzbddzbb
堍: bdfehdzbena
堑: b3dfeebdbdb
堕: rdbedubbbdb
堙: bdfbdzddbbdb
堞: bdfbddb2bdec
堠: bdfedzbebbec
堡: eddzbbdecbdb
堤: bdfdzbbbdbec
堪: bdfbddbbbea2
堰: bdfbdzbbieb2
堵: bdfbdbedzbb
塃: bdfbddab2edn
塄: bdfdzddbabue
塆: bdfabddaazbx
塈: zbbjab2enbdb
塌: bdfdzbbuafuaf
塍: eubbaebbecbdb
塑: aeb2deeubbbdb
塔: bdfbddecbdzb
塘: bdfabezbbddzb
塞: aahbbddbecbdb
塥: bdfbdzbduaebd
填: bdfbddzbbbbea
塬: bdfbeedzbbmea
塮: bdfedubbbebma
塾: abdzbhmfewabdb
墀: bdfzbedafeaebbd
墁: bdfdzbbdzddbhc
境: bdfabaebdzbben
墅: dzbbdbfhahmbdb
墈: bdfbddbbbea2ue
墉: bdfabezbbdubbd
墒: bdfabaedueadzb
墓: bdddzbbbecbdb
墙: bdfbdaebdzdzbb
增: bdfaedzdaebdzbb
墟: bdfdbhebnddaeb
墦: bdfeaebdecdzbdb
墨: dzaebdbbaaaabdb
墩: bdfabdzbhmfebec
墼: bdzbbbd2deqhcbdb
壁: zbedzbabaebbdbdb
壅: ab33eedabbbdbbdb
壑: dbahbeaecdzbhcbdb
壕: bdfabdzbahbeleeec
壤: bdfabdzbdzbbbddbejec
士: bdb
壬: ebdb
壮: afdbdb
声: bdbzdbe
壳: bdbahew
壶: bdbahddaeb
壹: bdbahbdzbaeb
处: ehcda
备: ehcdzbdb
复: ebdzbbehc
夏: bedzbbbehc
夔: aebedzbbbdbdfzbneaehc
夕: eha
外: ehada
夙: ewbeha
多: ehaeha
夜: abedehac
够: eudzbehaeha
夤: ehaaahbdzbdbea
夥: dzbbbdeaehaeha
大: bec
天: bbec
太: beca
夫: bbec
夬: zbec
夭: ebec
央: dzbec
夯: becue
失: ebbec
头: aabea
夷: bzbxec
夸: becbbx
夹: baebec
夺: becbma
夼: becedd
奁: becbea2
奂: ehdzbec
奄: becdzbbn
奇: beabdzbm
奈: becbbmea
奉: bbbecbbd
奋: becdzbdb
奎: becbdbbdb
奏: bbbecbbea
契: bbbduebec
奔: becbdbed
奕: abemeabec
奖: afdehabec
套: becbdbbb3a
奘: 2dbebdbbec
奚: eaae33abec
奠: aebdze2bbbec
奢: becbdbedzbb
奥: edzaebdeabec
奭: bbedzbbbedzbbec
女: ieb
奴: iebhc
奶: iebre
奸: iebbbd
她: iebudn
好: iebhmb
妁: iebeua
如: iebdzb
妃: iebzbn
妄: ab2ieb
妆: afdieb
妇: iebzbb
妈: iebzxb
妊: iebebdb
妍: iebbbed
妒: iebazbe
妓: iebbdhc
妖: iebebec
妗: iebecah
妙: iebdeae
妞: iebzdbb
妣: iebbjen
妤: iebhahm
妥: eaaeieb
妨: iebabue
妩: iebbben
妪: iebbea2
妫: iebaeua
妮: iebzbeen
妯: iebdzbdb
妲: iebdzbbb
妹: iebbbdec
妻: bzbbdieb
妾: abaebieb
姆: ieb2uaba
姊: iebexde
始: ieb3adzb
姐: iebdzbbb
姑: iebbddzb
姒: iebjaea
姓: iebebbdb
委: ebdecieb
姗: iebeueub
姘: iebaebbed
姚: iebeafnea
姜: aebbdbieb
姝: iebebbdec
姞: iebbdbdzb
姣: iebabeaec
姥: iebbdbeen
姨: iebbzbxec
姬: iebbddzbd2
姹: iebaahebn
姻: iebdzbeab
姽: iebehbeun
姿: afehecieb
威: bebieboea
娃: iebbdbbdb
娄: aebdecieb
娅: iebbddaeb
娆: iebboeben
娇: iebebeced
娈: abddeaieb
娉: iebdzbdbbx
娌: iebdzbbdbb
娑: aafdeaeieb
娓: iebzbeebbn
娘: iebazbbjec
娜: iebubberd
娟: iebdzbdubb
娠: iebbebbjec
娣: iebaezbxde
娥: iebebmfoea
娩: iebehdzben
娱: iebdzbbbec
娲: iebdzbduea
娴: iebadubdea
娶: bddbbfhcieb
娼: iebdzbbdzbb
婀: iebrdbdzbm
婆: aafhedhcieb
婉: iebaahehaun
婊: iebbbdbejec
婕: iebbzbbdbec
婚: iebejbodzbb
婞: iebbdbaebbd
婢: iebedzbbebd
婧: iebbbdbdubb
婪: bdeabdecieb
婳: iebbdzbdb2d
婴: dzeadzeaieb
婵: iebaedzbbbd
婶: iebaahdzbbd
婷: iebabdzbahbm
婺: hahmeebecieb
婿: iebhdbecdubb
媒: iebbddbbbdec
媚: iebzdbedzbbb
媛: iebeaaebbehc
媪: iebdzbbdzddb
媲: iebedzeabbjen
媳: iebedzbbbaoaa
媵: eubbaebbecieb
媸: ieb2ddbdzbdba
媾: iebbbddbdubdb
嫁: iebaahbeleeec
嫂: iebedbzbbdhc
嫉: iebabeafebbec
嫌: iebaebzbbddec
嫒: iebeaaeahbehc
嫔: iebaahedbdbea
嫖: iebbdzddbbbmea
嫘: iebdzbdb33amea
嫚: iebdzbbdzddbhc
嫜: iebabaebdzbbbd
嫠: bbdeaebecbeieb
嫡: iebabaedubddzb
嫣: iebbdbdbbxaaaa
嫦: iebdaeahdzbdud
嫩: iebbdzbdeaebec
嫪: iebzafzafeceee
嫫: iebbdddzbbbec
嫱: iebbdaebdzdzbb
嬉: iebbdbdzbaebdzb
嬖: zbedzbabaebbdieb
嬗: iebabdzdzbbdzbbb
嬴: ab2dzbeubbiebewa
嬷: iebabebdeabdece3a
孀: iebbahdaaaabdeadzbbb
子: hmb
孑: hmf
孓: hmc
孔: hmfn
孕: rehmb
字: aahhmb
存: bedhmb
孙: hmfmea
孚: eaaehmb
孛: bdahhmb
孜: hmfebec
孝: bdbehmb
孟: hmbdzddb
孢: hmfeuzbn
季: ebdechmb
孤: hmfeejac
孥: iebhchmb
学: aaeahhmb
孩: hmfab3eea
孪: abddeahmb
孬: bedaiebhmb
孰: abdzbhmfewa
孱: zbehmbhmfhmb
孳: aeb33a33ahmb
孵: ejaeudaeaaehmb
孺: hmfbahdaaaabedudd
孽: bddedzbzbabaebbdhmb
宁: aahbm
它: aahen
宄: aahew
宅: aahebn
宇: aahbbm
守: aahbma
安: aahieb
宋: aahbdec
完: aahbben
宏: aahbe3a
宓: aahaoaea
宕: aahbedzb
宗: aahbbmea
官: aahdzbzb
宙: aahdzbdb
定: aahbdbec
宛: aahehaun
宜: aahdzbbb
宝: aahbbdba
实: aahaabea
宠: aahbenea
审: aahdzbbd
客: aahehcdzb
宣: aahbdzbbb
室: aahb3abdb
宥: aahbedubb
宦: aahbdzbd2
宪: aahebdben
宫: aahdzbdzb
宬: aahbeuoea
宰: aahabaebbd
害: aahbbbddzb
宴: aahdzbbieb
宵: aahdaedubb
家: aahbeleeec
宸: aahbebbjec
容: aaheaecdzb
宽: aahbdddzen
宾: aahedbdbea
宿: aahedbedzbb
寂: aahdbbmeahc
寄: aahbeabdzbm
寅: aahbdzbdbea
密: aahaoaead2d
寇: aahbbendbha
富: aahbdzbdzbdb
寐: aah2dbebbdec
寒: aahbbddbecaa
寓: aahdzbbdudfa
寝: aahafdzbbahhc
寞: aahbdddzbbbec
察: aahehaahcbbmea
寡: aahbedzbbbecue
寤: aah2dbebdzbdzb
寥: aahzafzafeceee
寨: aahbbddbecbmea
寮: aahbecaedzbbmea
寰: aahdzddbbdzbejec
寸: bma
对: habma
寺: bdbbma
寻: zbbbma
导: zbnbma
寿: bbbebma
封: bdbbdfbma
射: edubbbebma
将: afdehabma
尉: zbebbmeabma
尊: aebdze2bbbma
小: mea
少: deae
尔: ehmea
尕: 7emea
尖: deabec
尘: deabdb
尚: daedudzb
尜: deabecmea
尝: daeahbb3a
尤: bena
尥: beneua
尧: boeben
尬: beneced
就: abdzbmeabena
尴: benddebadzddb
尸: zbe
尹: zbbe
尺: zbec
尻: zbeew
尼: zbeen
尽: zbecaa
尾: zbeebbn
尿: zbemhec
局: zbeudzb
屁: zbebjen
层: zbebb3a
屃: zbedzea
居: zbebddzb
屈: zbe2dd2d
屉: zbebddb2
届: zbedzbdb
屋: zbeb3abdb
屎: zbeaebdec
屏: zbeaebbed
屐: zbeeedbdhc
屑: zbedaedubb
展: zbebddbjec
屙: zberdbdzbm
属: zbeedzbdudfa
屠: zbebdbedzbb
屡: zbeaebdecieb
屣: zbeeeddbdbdbec
履: zbeeedebdzbbehc
屦: zbeeedaebdecieb
屯: b2dn
山: d2d
屹: d2debw
屺: d2dzbn
屿: d2dbxb
岁: d2deha
岂: d2dzbn
岈: d2db3me
岌: d2de6c
岍: d2dbbed
岐: d2dbdhc
岑: d2decah
岔: ecued2d
岖: d2dbea2
岗: d2dduea
岘: d2ddzen
岙: ebecd2d
岚: d2dewea
岛: euaxd2d
岢: d2dbdzbm
岣: d2deudzb
岩: d2dbedzb
岫: d2ddzbdb
岬: d2ddzbbd
岭: d2decaha
岱: edboad2d
岳: edbdbd2d
岵: d2dbddzb
岷: d2dzbjbo
岸: d2dbebbd
岿: d2ddezbb
峁: d2dejeud
峂: d2dehcaa
峄: d2dhcbbd
峋: d2deudzbb
峒: d2ddubdzb
峙: d2dbdbbma
峡: d2dbaebec
峣: d2dboeben
峤: d2debeced
峥: d2dehzbbm
峦: abddead2d
峧: d2dabeaec
峨: d2debmfoea
峪: d2deaecdzb
峭: d2ddaedubb
峰: d2dehcbbbd
峻: d2d3aeaehc
崂: d2dbddahue
崃: d2dbaebdec
崆: d2daaheabdb
崇: d2daahbbmea
崎: d2dbeabdzbm
崔: d2dedabbbdb
崖: d2dbebdbbdb
崛: d2dzbe2dd2d
崞: d2dabdzbhmb
崟: d2decbbdaeb
崤: d2deabedubb
崦: d2dbecdzbbn
崩: d2deubbeubb
崭: d2db3dfeebd
崮: d2ddzbddzbb
崴: d2dbebieboea
崽: d2ddzbdbaoaa
嵇: ebdeabenad2d
嵊: d2debddbfenec
嵋: d2dzdbedzbbb
嵌: d2dbddbbehec
嵎: d2ddzbbdudfa
嵖: d2dbdecdzbbb
嵘: d2dbddahbdec
嵚: d2debbbjehec
嵛: d2decbdubbdm
嵝: d2daebdecieb
嵩: d2dabdzbdudzb
嵫: d2daeb33a33a
嵬: d2dedzbben3a
嵯: d2daebbbebdb
嵴: d2dafeaecdubb
嶂: d2dabaebdzbbbd
嶓: d2deaebdecdzbdb
嶙: d2daebdecehab3d
嶝: d2dhaeecbdzbaeb
嶷: d2denebbeahahdbec
巅: d2dbddzbbbbeabedzea
巉: d2dehdzbbjenehdzbena
巍: d2debdeaiebedzbben3a
川: edd
州: aeadad
巡: iiia6c
巢: iiidzbbbdec
工: bdb
左: bebdb
巧: bdfbx
巨: bzb2
巩: bdfewa
巫: bdeaeab
差: aebbbebdb
巯: habdfab3aedn
己: zbn
已: zbn
巳: zbn
巴: zdbn
巷: bddbeczbn
巽: zbnzbnbddbea
巾: dud
币: edud
市: abdud
布: bedud
帅: dedud
帆: dudewa
师: debdud
希: eabedud
帏: dudbbud
帐: dudebjc
帑: iebhcdud
帔: dudhedhc
帕: dudedzbb
帖: duddbdzb
帘: aaheadud
帙: dudebbec
帚: zbbahdud
帛: edzbbdud
帜: duddzbea
帝: abaeahdud
帡: dudaebbed
带: bdddahdud
帧: duddbdzea
席: abebddbdud
帮: bbberddud
帱: dudbbbebma
帷: dudedabbbdb
常: daeahdzbdud
帻: dudbbdbdzea
帼: duddzbbdbab
帽: duddzbbdzbbb
幂: ahdzbbbecdud
幄: dudzbeb3abdb
幅: dudbdzbdzbdb
幌: duddzbbdaeben
幔: duddzbbdzddbhc
幕: bdddzbbbecdud
幛: dudabaebdzbbbd
幞: dudddaebaebbbec
幡: dudeaebdecdzbdb
幢: dudabaebdzbbdbb
幪: dudbddahbbeleeec
干: bbd
平: baebd
年: ebbdbd
并: aebbed
幸: bdbaebbd
幺: 33a
幻: 33au
幼: 33aue
幽: d33a33a2d
广: abe
庀: abeen
庄: abebdb
庆: abebec
庇: abebjen
床: abebdec
庋: abebdhc
序: abehahm
庐: abeazbe
庑: abebben
库: abeb3bd
应: abeaaeb
底: abeejboa
庖: abeeuzbn
店: abedbdzb
庙: abedzbdb
庚: abezbbec
府: abeedbma
庞: abebenea
废: abe3ehca
庠: abeaebbbd
庤: abebdbbma
庥: abeedbdec
度: abebddbhc
座: abeeaeabdb
庭: abeebdb6c
庳: abeedzbbebd
庵: abebecdzbbn
庶: abebddbaaaa
康: abezbbmafec
庸: abezbbdubbd
庹: abebddbzbec
庼: abebjbedzea
庾: abeedbzbbec
廉: abeaebzbbddec
廊: abeazbbjard
廋: abeedbzbbdhc
廒: abebbdbueebec
廓: abeabdzbhmfrd
廖: abezafzafeceee
廙: abedzbdbbddbea
廛: abedzbbdbbeabdb
廨: abeeheubbdueebbd
廪: abeabdzdzbbbbmea
延: edb26c
廷: ebdb6c
建: zbbbbd6c
廿: bddb
开: bbed
弁: 3abed
异: zbnbed
弃: ab3abed
弄: bbdbbed
弇: ecbdzbbed
弈: abemeabed
弊: aedudeaebecbed
弋: boa
式: bbdfoa
弑: eabmeabbdfoa
弓: zbx
引: zbxd
弗: zbxed
弘: zbx3a
弛: zbxudn
弟: aezbxde
张: zbxebjc
弥: zbxehmea
弦: zbxab33a
弧: zbxeejac
弩: iebhczbx
弭: zbxbddbbb
弯: abddeazbx
弱: zbxafzbxaf
弹: zbxaedzbbbd
强: zbxdzbdzbdba
弼: zbxbedzbbzbx
彀: bdbahbzbxeqhc
归: dezbb
当: daezbb
录: zbbmafec
彖: 3hbeleeec
彗: bbbdbbbdzbb
彘: 3hbbjebbeaen
彝: 3hbaebdea33ameabed
形: bbedeee
彤: euabeee
彦: abaebeeee
彧: bdzbfoeeea
彩: eaaebdeaeee
彪: dbhebneweee
彬: bdeabdeaeee
彭: bdbdzbaefeee
彰: abaebdzbbbdeee
影: dzbbabdzbmeaeee
彳: eed
彷: eedabue
役: eedeqhc
彻: eedbjue
彼: eedhedhc
往: eedabbdb
征: eedbdbdb
徂: eeddzbbb
径: eedhabdb
待: eedbdbbma
徇: eedeudzbb
很: eedzbbjec
徉: eedaebbbd
徊: eeddzdzbb
律: eedzbbbbd
徐: eedecbbmea
徒: eedbdbdbec
徕: eedbaebdec
得: eeddzbbbbma
徘: eeddbbbdbbb
徙: eeddbdbdbec
徜: eeddaedudzb
御: eedebbdbdfud
徨: eededzbbbbdb
循: eedeebddzbbb
徭: eedeaaeebbd2d
微: eedd2dbekebec
徵: eedd2dbbbdbebec
德: eedbedzddbbaoaa
徼: eededzbbabueebec
徽: eedd2db33ameaebec
心: aoaa
必: aoaea
忆: aadw
忉: aadue
忌: zbnaoaa
忍: ueaaoaa
忏: aadebd
忐: dbbaoaa
忑: bdaaoaa
忒: baoaaoa
忖: aadbma
志: bdbaoaa
忘: ab2aoaa
忙: aadab2
忝: bbecmaaa
忠: dzbdaoaa
忡: aaddzbd
忤: aadebbd
忧: aadbena
忪: aadec3a
快: aadzbec
忭: aadabda
忮: aadbdhc
忱: aadahen
念: ecahaoaa
忸: aadzdbb
忻: aadeebd
忽: eueeaoaa
忾: aadebbw
忿: ecueaoaa
怀: aadbeda
态: becaaoaa
怂: eaecaoaa
怃: aadbben
怄: aadbea2
怅: aadebjc
怆: aadecun
怊: aaduedzb
怍: aadebdbb
怎: ebdbbaoaa
怏: aaddzbec
怒: iebhcaoaa
怔: aadbdbdb
怕: aadedzbb
怖: aadbedud
怙: aadbddzb
怛: aaddzbbb
怜: aadecaha
思: dzbdbaoaa
怠: 3adzbaoaa
怡: aad3adzb
急: ehzbbaoaa
怦: aadbaebd
性: aadebbdb
怨: ehaunaoaa
怩: aadzbeen
怪: aadhcbdb
怫: aadzbxed
怯: aadbdb3a
怵: aadbdeca
总: aedzbaoaa
怼: habmaaoaa
怿: aadhcbbd
恁: edebdbaoaa
恂: aadeudzbb
恃: aadbdbbma
恋: abddeaaoaa
恍: aaddaeben
恐: bdfewaaoaa
恒: aadbdzbbb
恕: iebdzbaoaa
恙: aebbdbaoaa
恚: bdbbdbaoaa
恝: bbbdueaoaa
恢: aadbeaeec
恣: afehecaoaa
恤: aadedzddb
恧: beduddaoaa
恨: aadzbbjec
恩: dzbeabaoaa
恪: aadehcdzb
恫: aaddubdzb
恬: aadebddzb
恭: bddbecmaaa
息: edzbbbaoaa
恰: aadecbdzb
恳: zbbjecaoaa
恶: bddaebaoaa
恸: aadbb3aue
恹: aadbebeca
恺: aadd2dzbn
恻: aaddzeadm
恼: aadabea2d
恽: aadahb3bd
恿: hadubbdaoaa
悃: aaddzbdeab
悄: aaddaedubb
悉: eaebdecaoaa
悌: aadaezbxde
悍: aaddzbbbbd
悒: aaddzbzdbn
悔: aadeb2uaba
悖: aadbdahhmb
悚: aadbdzbdec
悛: aad3aeaehc
悝: aaddzbbdbb
悟: aadbdzbdzb
悠: eddebecaoaa
悢: aadazbbjec
患: dzbdzbdaoaa
悦: aadaedzben
您: edehmeaaoaa
悫: bdbahewaoaa
悬: dzbbb3aaoaa
悭: aadddhcbdb
悯: aadaduabea
悱: aaddbbbdbbb
悲: dbbbdbbbaoaa
悴: aadabeaeabd
悸: aadebdechmb
悻: aadbdbaebbd
悼: aaddbdzbbbd
情: aadbbdbdubb
惆: aadeubdbdzb
惇: aadabdzbhmb
惊: aadabdzbmea
惋: aadaahehaun
惑: bdzbfoeaaoaa
惕: aaddzbbeuee
惘: aadduaebab2
惚: aadeueeaoaa
惜: aadbddbdzbb
惝: aaddaedudzb
惟: aadedabbbdb
惠: bdzbbdbaaoaa
惦: aadabedbdzb
惧: aaddzbbbbea
惨: aad3abeceee
惩: eedbdbdbaoaa
惫: ehcdzbdbaoaa
惬: aadbbaebea2
惭: aadb3dfeebd
惮: aadaedzbbbd
惯: aad2zdbdzea
惰: aadbebdbdubb
想: bdeadzbbbaoaa
惴: aadd2dbedudd
惶: aadedzbbbbdb
惹: bddbedzbaoaa
惺: aaddzbbebbdb
愀: aadebdeaaeec
愁: ebdeaaeecaoaa
愆: eedaafbbmaoaa
愈: ecbdubbdmaoaa
愉: aadecbdubbdm
愎: aadebdzbbehc
意: abaebdzbbaoaa
愔: aadabaebdzbb
愕: aaddzbdzbbbx
愚: dzbbdudfaaoaa
感: bebdzboeaaoaa
愠: aaddzbbdzddb
愣: aaddzddbabue
愤: aadbdbdddzea
愦: aaddzbdbdzea
愧: aadedzbben3a
愫: aadbbdb33amea
愿: beedzbbmeaaoaa
慈: aeb33a33aaoaa
慊: aadaebzbbddec
慌: aadbddab2edn
慎: aadbddzbbbbea
慑: aadbddbbbhahc
慕: bdddzbbbecmaaa
慝: bbddbedzb2aoaa
慢: aaddzbbdzddbhc
慥: aadebdbdzba6c
慧: bbbdbbbdzbbaoaa
慨: aadzbbjab3en
慭: baebdeabecaaoaa
慰: zbebbmeabmaaoaa
慵: aadabezbbdubbd
慷: aadabezbbmafec
憋: aedudeaebecaoaa
憎: aadaedzdaebdzbb
憔: aadedabbbdbaaaa
憝: abdzbhmfebecaoaa
憧: aadabaebdzbbdbb
憨: hbddbbfebecaoaa
憩: ebddzbedzbbbaoaa
憬: aaddzbbabdzbmea
憷: aadbdeabdeahdbec
憾: aadbebdzboeaaoaa
懂: aadbddebdzbbdbb
懈: aadeheubbdueebbd
懊: aadedzaebdeabec
懋: bdeahahmebdecaoaa
懑: aafbddbdueaeaaoaa
懒: aadbdzbdeaehdzea
懦: aadbahdaaaabedudd
懵: aadbdddzddbahdzbbb
懿: bdbahbdzbaefafehecaoaa
戆: abaebdzbbbdehcbdbdzeaaoaa
戈: boea
戊: beoea
戋: bboea
戌: beboea
戍: beaoea
戎: bbeoea
戏: haboea
成: beuoea
我: ebmfoea
戒: bbedoea
戕: 2dbeboea
或: bdzbfoea
戗: eaunboea
战: dbdzbboea
戚: bedbbmeaoea
戛: bedzbbbboea
戟: bddzbbbdboea
戡: bddbbbea2boea
戢: dzbbddbbfoea
戥: dzbbebbdfboea
截: bdbedabbbdboea
戬: bddaebdzbbboea
戮: zafzafeaeeeboea
戳: zafzafedabbbdbboea
戴: bdbdzbdbbddbeaoea
户: azbe
戽: azbeaabd
戾: azbebeca
房: azbeabue
所: eezbeebd
扁: azbedubdd
扃: azbedudzb
扅: azbeehaeha
扇: azbeuafuaf
扈: azbedzbzdbn
扉: azbedbbbdbbb
扊: azbeaeeaaeec
手: ebbm
才: bme
扎: bmfn
扑: bmfda
扒: bmfec
打: bmfbm
扔: bmfre
托: bmfebn
扛: bmfbdb
扣: bmfdzb
扦: bmfebd
执: bmfewa
扩: bmfabe
扪: bmfadu
扫: bmfzbb
扬: bmfree
扭: bmfzdbb
扮: bmfecue
扯: bmfdbdb
扰: bmfbena
扳: bmfeehc
扶: bmfbbec
批: bmfbjen
扺: bmfejbo
扼: bmfbeun
找: bmfboea
承: hmbbbhec
技: bmfbdhc
抃: bmfabda
抄: bmfdeae
抉: bmfzbec
把: bmfzdbn
抑: bmfejud
抒: bmfhahm
抓: bmfeedc
抔: bmfbeda
投: bmfeqhc
抖: bmfaabd
抗: bmfabew
折: bmfeebd
抚: bmfbben
抛: bmfewue
抟: bmfbb5a
抠: bmfbea2
抡: bmfecen
抢: bmfecun
护: bmfazbe
报: bmfudhc
抨: bmfbaebd
披: bmfhedhc
抬: bmf3adzb
抱: bmfeuzbn
抵: bmfejboa
抹: bmfbbdec
抻: bmfdzbbd
押: bmfdzbbd
抽: bmfdzbdb
抿: bmfzbjbo
拂: bmfzbxed
拃: bmfebdbb
拄: bmfabbdb
担: bmfdzbbb
拆: bmfeebda
拇: bmf2uaba
拈: bmfdbdzb
拉: bmfabaeb
拊: bmfedbma
拌: bmfaebbd
拍: bmfedzbb
拎: bmfecaha
拐: bmfdzbue
拒: bmfbzb2
拓: bmfbedzb
拔: bmfbehca
拖: bmfebudn
拗: bmf33aue
拘: bmfeudzb
拙: bmf2dd2d
拚: bmf3abed
招: bmfuedzb
拜: ebbebbbbd
拟: bmfjaea
拢: bmfbenea
拣: bmfb3uea
拤: bmfdbbda
拥: bmfeubbd
拦: bmfaebbb
拧: bmfaahbm
拨: bmf3ehca
择: bmfhcbbd
括: bmfebddzb
拭: bmfbbdfoa
拮: bmfbdbdzb
拯: bmfhmhecb
拱: bmfbddbea
拳: aebbecebbm
拴: bmfecbbdb
拶: bmfiiieha
拷: bmfbdbebx
拼: bmfaebbed
拽: bmfdzbboe
拾: bmfecbdzb
拿: ecbdzbebbm
持: bmfbdbbma
挂: bmfbdbbdb
指: bmfendzbb
挈: bbbdueebbm
按: bmfaahieb
挎: bmfbecbbx
挑: bmfeafnea
挖: bmfaaheaw
挚: bmfewaebbm
挛: abddeaebbm
挝: bmfbmaa6c
挞: bmfbeaa6c
挟: bmfbaebec
挠: bmfboeben
挡: bmfdaezbb
挢: bmfebeced
挣: bmfehzbbm
挤: bmfabeced
挥: bmfahb3bd
挦: bmfzbbbma
挨: bmf3aebbec
挪: bmfubberd
挫: bmfeaeabdb
振: bmfbebbjec
挲: aafdeaeebbm
挹: bmfdzbzdbn
挺: bmfebdb6c
挽: bmfehdzben
捂: bmfbdzbdzb
捃: bmfzbbedzb
捅: bmfhadubbd
捆: bmfdzbdeab
捉: bmfdzbdbec
捋: bmfeaaebma
捌: bmfdzbuedm
捍: bmfdzbbbbd
捎: bmfdaedubb
捏: bmfdzbbbdb
捐: bmfdzbdubb
捕: bmfbdubbda
捞: bmfbddahue
损: bmfdzbdzea
捡: bmfecbaaeb
换: bmfehdzbec
捣: bmfeuaxd2d
捧: bmfbbbecbbd
捩: bmfazbebeca
捭: bmfedzbbebd
据: bmfzbebddzb
捯: bmfb3abdfdm
捶: bmfebdbddbb
捷: bmfbzbbdbec
捺: bmfbecbbmea
捻: bmfecahaoaa
掀: bmfeebdehec
掂: bmfabedbdzb
掇: bmfhahahahc
授: bmfeaaeahhc
掉: bmfdbdzbbbd
掊: bmfabaebdzb
掌: daeahdzbebbm
掎: bmfbeabdzbm
掏: bmfeuebbd2d
掐: bmfehedbzbb
排: bmfdbbbdbbb
掖: bmfabedehac
掘: bmfzbe2dd2d
掠: bmfabdzbmea
探: bmfaheabdec
掣: ebbduddmebbm
接: bmfabaebieb
控: bmfaaheabdb
推: bmfedabbbdb
掩: bmfbecdzbbn
措: bmfbddbdzbb
掬: bmfeuaebdea
掭: bmfbbecmaaa
掮: bmfazbedubb
掰: ebbeecueebbm
掳: bmfdbhebnue
掴: bmfdzbbdbab
掷: bmfaebbeard
掸: bmfaedzbbbd
掺: bmf3abeceee
掼: bmf2zdbdzea
掾: bmf3hbeleeec
揄: bmfecbdubbdm
揆: bmfhaeecbbea
揉: bmfhahmebdec
揍: bmfbbbecbbea
揎: bmfaahbdzbbb
描: bmfbdddzbdb
提: bmfdzbbbdbec
插: bmfebdedbzbb
揖: bmfdzbbddbbb
揞: bmfabaebdzbb
揠: bmfbdzbbieb2
握: bmfzbeb3abdb
揣: bmfd2dbedudd
揩: bmfbjenedzbb
揪: bmfebdeaaeec
揭: bmfdzbbeuea2
揳: bmfbbbduebec
援: bmfeaaebbehc
揶: bmfbddbbfrd
揸: bmfbdecdzbbb
揽: bmfddebadzen
揾: bmfdzbbdzddb
揿: bmfebbbjehec
搀: bmfehdzbenaa
搁: bmfaduehcdzb
搂: bmfaebdecieb
搅: bmfaaeahdzen
搋: bmfeedbhebnew
搌: bmfzbebddbjec
搏: bmfbdzbbdabma
搐: bmfab33adzbdb
搒: bmfabaeahabue
搓: bmfaebbbebdb
搔: bmfhcadzbdba
搛: bmfaebzbbddec
搜: bmfedbzbbdhc
搞: bmfabdzbdudzb
搠: bmfaeb2deeubb
搡: bmfhahahabdec
搦: bmfzbxafzbxaf
搪: bmfabezbbddzb
搬: bmfeeuabaeqhc
搭: bmfbddecbdzb
搴: aahbbddbecebbm
携: bmfedabbbdbre
搽: bmfbddecbmea
摁: bmfdzbeabaoaa
摄: bmfbddbbbhahc
摅: bmfdbhebnaoaa
摆: bmfdzddbbdb3a
摇: bmfeaaeebbd2d
摈: bmfaahedbdbea
摊: bmfhaedabbbdb
摒: bmfzbeaebbed
摔: bmfab33aafeabd
摘: bmfabaedubddzb
摞: bmfdzbdb33amea
摧: bmfd2dedabbbdb
摩: abebdeabdecebbm
摭: bmfabebddbaaaa
摸: bmfbdddzbbbec
摹: bdddzbbbecebbm
摺: bmfzafzafedzbb
摽: bmfbdzddbbbmea
撂: bmfdzbdbehcdzb
撄: bmfdzeadzeaieb
撅: bmfbeaeb2beehec
撇: bmfaedudeaebec
撑: bmfdaeahdzbebbm
撒: bmfbddbdubbebec
撕: bmfbddbbbeaeebd
撖: bmfhbddbbfebec
撙: bmfaebdze2bbbma
撞: bmfabaebdzbbdbb
撤: bmfab3adubbebec
撩: bmfbecaedzbbmea
撬: bmfebbnebbjebbn
播: bmfeaebdecdzbdb
撮: bmfdzbbbddbbfhc
撰: bmfzbnzbnbddbea
撵: bmfbbeabbecb3bd
撷: bmfbdbdzbbedzea
撸: bmfehdzbdbbdzbb
撺: bmfaaheadzbdzbd
撼: bmfbebdzboeaaoaa
擀: bmfbddzbbbdecbbd
擂: bmfbahdaaaadzbdb
擅: bmfabdzdzbbdzbbb
操: bmfdzbdzbdzbbdec
擎: bddeudzbebecebbm
擐: bmfdzddbbdzbejec
擒: bmfecabea2ddu3a
擘: zbedzbabaebbdebbm
擞: bmfaebdeaiebebec
擢: bmfzafzafedabbbdb
擤: bmfedzbbbdzbdbbed
擦: bmfaahehaahcbbmea
攀: bdeaeaeabdeabecebbm
攉: bmfbahdaaaaedabbbdb
攒: bmfebdbejebdbendzea
攘: bmfabdzbdzbbbddbejec
攥: bmfebaebadzbbbbec33amea
攫: bmfdzbbbdzbbbedabbbdbhc
攮: bmfbdzbdahdzbdzbbbddbejec
支: bdhc
收: jdebec
攸: eddebec
改: zbjebec
攻: bdfebec
放: abueebec
政: bdbdfebec
故: bddzbebec
效: abeaeaebec
敉: aebdeaebec
敌: ebddzbebec
敏: eb2uabaebec
救: bmafeaaebec
敕: bdzbdeaebec
敖: bbdbueebec
教: bdbehmfebec
敛: eabaaefebec
敝: aedudeaebec
敞: daedudzbebec
敢: hbddbbfebec
散: bddbdubbebec
敦: abdzbhmfebec
敫: edzbbabueebec
敬: bddeudzbebec
数: aebdeaiebebec
敲: abdzbdudzbdbhc
整: bdzbdeaebecbdbdb
敷: bdzbbdaabueebec
文: abec
斋: abecbedudd
斌: abeabbdbdfoa
斐: dbbbdbbbabec
斑: bbdfabeabbdb
斓: abeaadubdzaebdea
斗: aabd
料: aebdeaaabd
斛: eheubbdaabd
斜: eabbmeaaabd
斝: dzbdzbahaabd
斟: bddbbbea2aabd
斡: bddzbbbdecaabd
斤: eebd
斥: eebda
斧: eaeceebd
斩: b3dfeebd
斫: bedzbeebd
断: aebdea2eebd
斯: bddbbbeaeebd
新: abaebbmeaeebd
方: abue
於: abueecaa
施: abueebudn
旁: abaeahabue
旃: abueebeuab
旄: abueebebbn
旅: abueebejec
旆: abueebbdud
旋: abueebhdbec
旌: abueebebbdb
旎: abueebzbeen
族: abueebebbec
旒: abueebab3aedn
旖: abueebbeabdzbm
旗: abueebbddbbbea
无: bben
既: zbbjab3en
日: dzbb
旦: dzbbb
旧: ddzbb
旨: endzbb
早: dzbbbd
旬: eudzbb
旭: ewdzbb
旮: ewdzbb
旯: dzbbew
旰: dzbbbbd
旱: dzbbbbd
时: dzbbbma
旷: dzbbabe
旸: dzbb7ee
旺: dzbbbbdb
旻: dzbbabec
昀: dzbbeuaf
昂: dzbbejud
昃: dzbbbeec
昆: dzbbbjen
昉: dzbbabue
昊: dzbbbbec
昌: dzbbdzbb
明: dzbbeubb
昏: ejbodzbb
易: dzbbeuee
昔: bddbdzbb
昕: dzbbeebd
昙: dzbbbb3a
昝: ehcdadzbb
星: dzbbebbdb
映: dzbbdzbec
春: bbbecdzbb
昧: dzbbbbdec
昨: dzbbebdbb
昭: dzbbuedzb
是: dzbbbdbec
昱: dzbbabaeb
昴: dzbbejeud
昵: dzbbzbeen
昶: auhecdzbb
昼: zbecdzbbb
昽: dzbbbenea
显: dzbbddaeb
晁: dzbbeafnea
晃: dzbbdaeben
晋: bddaebdzbb
晌: dzbbedudzb
晏: dzbbaahieb
晒: dzbbbdze2b
晓: dzbbboeben
晔: dzbbedenbd
晕: dzbbahb3bd
晖: dzbbahb3bd
晗: dzbbecahdzb
晚: dzbbehdzben
晞: dzbbeabedud
晟: dzbbbeuoea
晡: dzbbbdubbda
晢: bmfeebddzbb
晤: dzbbbdzbdzb
晦: dzbbeb2uaba
晨: dzbbbebbjec
普: aebddaebdzbb
景: dzbbabdzbmea
晰: dzbbbdeaeebd
晴: dzbbbbdbdubb
晶: dzbbdzbbdzbb
晷: dzbbehcdadzb
智: ebbeadzbdzbb
晾: dzbbabdzbmea
暂: b3dfeebddzbb
暄: dzbbaahbdzbbb
暅: dzbbaadbdzbbb
暇: dzbbzbdbbzbhc
暌: dzbbhaeecbbea
暑: dzbbbdbedzbb
暖: dzbbeaaebbehc
暗: dzbbabaebdzbb
暝: dzbbahdzbbabea
暧: dzbbeaaeahbehc
暨: zbbjab3endzbbb
暮: bdddzbbbecdzbb
暴: dzbbbddbecmafea
暹: dzbbedabbbdba6c
暾: dzbbabdzbhmfebec
曈: dzbbabaebdzbbdbb
曙: dzbbdzddbbdbedzbb
曛: dzbbebdzaebdbbaaaa
曜: dzbbzafzafedabbbdb
曝: dzbbdzbbbddbecmafea
曦: dzbbaebbdbebdeabxoea
曩: dzbbabdzbdzbbbddbejec
曰: dzbb
曲: dzbddb
曳: dzbboe
更: bdzbbec
曷: dzbbeuea2
曹: bdzbddbdzbb
曼: dzbbdzddbhc
曾: aedzdaebdzbb
替: bbeabbecdzbb
最: dzbbbddbbfhc
月: eubb
有: bedubb
朊: eubbbben
朋: eubbeubb
服: eubbudhc
朐: eubbeudzb
朔: aeb2deeubb
朕: eubbaebbec
朗: azbbjaeubb
朘: eubb3aeaehc
望: abjeubbbbdb
朝: bddzbbbdeubb
期: bddbbbeaeubb
朦: eubbbddahbbeleeec
木: bdec
未: bbdec
末: bbdec
本: bdecb
札: bdean
术: bdeca
朱: ebbdec
朴: bdeada
朵: eqbdec
机: bdeaew
朽: bdeabx
杀: eabmea
杂: ewbmea
权: bdeahc
杆: bdeabbd
杈: bdeahca
杉: bdeaeee
杌: bdeaben
李: bdechmb
杏: bdecdzb
材: bdeabme
村: bdeabma
杓: bdeaeua
杖: bdeabec
杜: bdeabdb
杞: bdeazbn
束: bdzbdec
杠: bdeabdb
条: ehcbmea
来: baebdec
杧: bdeaab2
杨: bdearee
杪: bdeadeae
杭: bdeaabew
杯: bdeabeda
杰: bdecaaaa
杲: dzbbbdec
杳: bdecdzbb
杵: bdeaebbd
杷: bdeazdbn
杻: bdeazdbb
杼: bdeahahm
松: bdeaec3a
板: bdeaeehc
极: bdeae6c
构: bdeaeu3a
枇: bdeabjen
枉: bdeabbdb
枋: bdeaabue
析: bdeaeebd
枕: bdeaahen
林: bdeabdec
枘: bdeaduea
枚: bdeaebec
果: dzbbbdec
枝: bdeabdhc
枞: bdeaeaec
枢: bdeabea2
枣: bdzdecaa
枥: bdeabeue
枧: bdeadzen
枨: bdeaebjc
枪: bdeaecun
枫: bdeaewea
枭: euaxbdec
枯: bdeabddzb
枰: bdeabaebd
枳: bdeadzbea
枵: bdeadzbbx
架: uedzbbdec
枷: bdeauedzb
枸: bdeaeudzb
柁: bdeaaahen
柃: bdeaecaha
柄: bdeabduea
柈: bdeaaebbd
柏: bdeaedzbb
某: bddbbbdec
柑: bdeabddbb
柒: aafbnbdec
染: aafewbdec
柔: hahmebdec
柘: bdeabedzb
柙: bdeadzbbd
柚: bdeadzbdb
柜: bdeabzb2
柝: bdeaeebda
柞: bdeaebdbb
柠: bdeaaahbm
柢: bdeaejboa
查: bdecdzbbb
柩: bdeabeha2
柬: bdzaebdec
柯: bdeabdzbm
柰: bdecbbmea
柱: bdeaabbdb
柳: bdeaejeud
柴: dbdfenbdec
柽: bdeahcbdb
柿: bdeaabdud
栀: bdeaeebun
栅: bdeaeueub
标: bdeabbmea
栈: bdeabboea
栉: bdeabddud
栊: bdeabenea
栋: bdeab3mea
栌: bdeadbzbe
栎: bdeae2mea
栏: bdeaaebbb
树: bdeahabma
栒: bdeaeudzbb
栓: bdeaecbbdb
栖: bdeabdze2b
栗: bdzddbbdec
栝: bdeaebddzb
栟: bdeaaebbed
校: bdeaabeaec
栩: bdeauafuaf
株: bdeaebbdec
栲: bdeabdbebx
栳: bdeabdbeen
样: bdeaaebbbd
核: bdeaab3eea
根: bdeazbbjec
格: bdeaehcdzb
栽: bdbbdeaoea
栾: abddeabdec
桀: ehab3dbdec
桁: bdeaeedbbm
桂: bdeabdbbdb
桃: bdeaeafnea
桄: bdeadaeben
桅: bdeaehbeun
框: bdeabbbdb2
案: aahiebbdec
桉: bdeaaahieb
桊: aebbecbdec
桌: dbdzbbbdec
桎: bdeab3abdb
桐: bdeadubdzb
桑: hahahabdec
桓: bdeabdzbbb
桔: bdeabdbdzb
桕: bdeaedbzbb
桡: bdeaboeben
桢: bdeadbdzea
档: bdeadaezbb
桤: bdead2dzbn
桥: bdeaebeced
桦: bdeaedenbd
桧: bdeaecbb3a
桨: afdehabdec
桩: bdeaabebdb
桫: bdeaaafdeae
桴: bdeaeaaehmb
桶: bdeahadubbd
桷: bdeaeheubbd
梁: aafueaabdec
梃: bdeaebdb6c
梅: bdeaeb2uaba
梆: bdeabbberd
梏: bdeaebdbdzb
梓: bdeaabaebbd
梗: bdeabdzbbec
梢: bdeadaedubb
梦: bdeabdeceha
梧: bdeabdzbdzb
梨: ebdeadmbdec
梭: bdea3aeaehc
梯: bdeaaezbxde
械: bdeabbedoea
梳: bdeaab3aedn
梵: bdeabdecewa
梽: bdeabdbaoaa
梾: bdeabaebdec
检: bdeaecbaaeb
棁: bdeaaedzben
棂: bdeazbbaeec
棉: bdeaedzbbdud
棋: bdeabddbbbea
棍: bdeadzbbbjen
棒: bdeabbbecbbd
棕: bdeaaahbbmea
棘: bdudeabdudec
棚: bdeaeubbeubb
棠: daeahdzbbdec
棣: bdeazbbmafec
棨: azbeebeabdec
棬: bdeaaebbecun
森: bdecbdeabdec
棰: bdeaebdbddbb
棱: bdeabdbeaehc
棵: bdeadzbbbdec
棹: bdeadbdzbbbd
棺: bdeaaahdzbzb
棻: bddeauebdec
棼: bdeabdeaecue
椁: bdeaabdzbhmb
椅: bdeabeabdzbm
椋: bdeaabdzbmea
植: bdeabddzbbbb
椎: bdeaedabbbdb
椐: bdeazbebddzb
椑: bdeaedzbbebd
椒: bdeadbbmeahc
椟: bdeabdhaabea
椠: b3dfeebdbdec
椤: bdeadzddbeha
椭: bdeardbedubb
椰: bdeabddbbfrd
椴: bdeaedbbfeqhc
椽: bdea3hbeleeec
椿: bdeabbbecdzbb
楂: bdeabdecdzbbb
楔: bdeabbbduebec
楗: bdeazbbbbd6c
楚: bdeabdeahdbec
楝: bdeabdzaebdec
楞: bdeadzddbabue
楠: bdeabdduaebbd
楣: bdeazdbedzbbb
楦: bdeaaahbdzbbb
楫: bdeadzbbddbbb
楮: bdeabdbedzbb
楯: bdeaeebddzbbb
楷: bdeabjenedzbb
楸: bdeaebdeaaeec
楹: bdearehadzddb
楼: bdeaaebdecieb
榀: bdeadzbdzbdzb
概: bdeazbbjab3en
榄: bdeaddebadzen
榆: bdeaecbdubbdm
榇: bdeaabaebbmea
榈: bdeaadudzbdzb
榉: bdeaaaebecbbd
榍: bdeazbedaedubb
榔: bdeaazbbjard
榕: bdeaaaheaecdzb
榖: bdbahbbdeaeqhc
榛: bdeabbbecebdea
榜: bdeaabaeahabue
榧: bdeabdbbbdbbb2
榨: bdeaaaheaebdbb
榫: bdeaedabbbdbbd
榭: bdeaedubbbebma
榴: bdeaejauedzbdb
榷: bdeaahedabbbdb
榻: bdeadzbbuafuaf
槁: bdeaabdzbdudzb
槊: aeb2deeubbbdec
槌: bdeaedzbzba6c
槎: bdeaaebbbebdb
槐: bdeaedzbben3a
槔: bdeaedzbbbecbd
槚: bdeabdzddbdzea
槛: bdeaddebadzddb
槜: bdeaedabbbdb7e
槟: bdeaaahedbdbea
槠: bdeaakbdbedzbb
槭: bdeabedbbmeaoea
槲: bdeaeheubbdaabd
槽: bdeabdzbddbdzbb
槿: bdeabddbdzbbbdb
樊: bdeaeaeabdeabec
樗: bdeabahdaaaabbx
樘: bdeadaeahdzbbdb
樟: bdeaabaebdzbbbd
模: bdeabdddzbbbec
樨: bdeazbedafeaebbd
横: bdeabddbdzbdbea
樯: bdeabdaebdzdzbb
樱: bdeadzeadzeaieb
樵: bdeaedabbbdbaaaa
樽: bdeaaebdze2bbbma
樾: bdeabdbdbecbjoea
橄: bdeahbddbbfebec
橇: bdeaebbnebbjebbn
橐: bdzbdahbedzbbdec
橘: bdeahahmedueadzb
橙: bdeahaeecbdzbaeb
橛: bdeabeaeb2deehec
橡: bdeaehdzbeleeec
橥: elebdbedzbbbdec
橦: bdeaabaebdzbbdbb
橱: bdeabebdzbaefbma
橹: bdeaehdzbdbbdzbb
橼: bdea33f3hbeleeec
檀: bdeaabdzdzbbdzbbb
檄: bdeaedzbbabueebec
檎: bdeaecabea2ddu3a
檐: bdeaehbeeaabbbdzb
檑: bdeabahdaaaadzbdb
檗: zbedzbabaebbdbdec
檠: bddeudzbebeabdec
檩: bdeaabdzdzbbbbmea
檫: bdeaaahehaahcbbmea
檬: bdeabddahbbeleeec
檵: bdea33a33ab33a33a2
欠: ehec
次: afehec
欢: haehec
欣: eebdehec
欤: bxfehec
欧: bea2ehec
欲: eaeadzbehec
欸: 3aebbeaehec
欺: bddbbbeaehec
款: bdbbbmeaehec
歃: ebdedbzbbehec
歆: abaebdzbbehec
歇: dzbbeuea2ehec
歉: aebzbbddeaehec
歌: bdzbdbdzbmehec
歙: eabdzbuafuafehec
止: dbdb
正: bdbdb
此: dbdfen
步: dbdbdee
武: bbdbdfoa
歧: dbdfbdhc
歪: bedabdbdb
歹: beha
死: behaen
歼: behaebd
殁: behaeqhc
殂: behadzbbb
殃: behadzbec
殄: behaeceee
殆: beha3adzb
殇: behaeb7ee
殉: behaeudzbb
殊: behaebbdec
残: behabboea
殍: behaeaaehmb
殒: behadzbdzea
殓: behaecbaaeb
殖: behabddzbbbb
殚: behaaedzbbbd
殛: behahmdzbhab
殡: behaaahedbdbea
殣: behabddbdzbbbdb
殪: behabdbahbdzbaeb
殳: eqhc
殴: bea2eqhc
段: edbbfeqhc
殷: eezbbueqhc
殿: zbebddbeaeqhc
毁: edbzbbbdfeqhc
毂: bdbahb3dfeqhc
毅: abaebeleeeaeqhc
毋: 2ueb
母: 2uaba
每: eb2uaba
毐: bdb2ueb
毒: bbdb2uaba
毓: eb2uabaab3aedn
比: bjen
毕: bjenbd
毖: bjenaoaea
毗: dzbdbbjen
毙: bjenbehaen
毛: ebbn
毡: ebbndbdzb
毪: ebbn3aebbd
毫: abdzbahebbn
毯: ebbnaeeaaeea
毳: ebbnebbjebbn
毵: 3abeaeeeebbn
毹: eabdubbdmebbn
毽: ebbnzbbbbd6c
氅: daedudzbebecebbn
氆: ebbnaebddaebdzbb
氇: ebbnehdzbdbbdzbb
氍: dzbbbdzbbbedabbbdbebbn
氏: ejbo
氐: ejboa
民: zbjbo
氓: ab2zbjbo
气: ebbw
氕: ebbwe
氖: ebbwre
氘: ebbwed
氙: ebbwd2d
氚: ebbwedd
氛: ebbwecue
氟: ebbwzbxed
氡: ebbwehcaa
氢: ebbwhabdb
氤: ebbwdzbeab
氦: ebbwab3eea
氧: ebbwaebbbd
氨: ebbwaahieb
氩: ebbwbddaeb
氪: ebbwbddzben
氮: ebbwaeeaaeea
氯: ebbwzbbmafea
氰: ebbwbbdbdubb
氲: ebbwdzbbdzddb
水: mhec
永: auhec
氽: ecmhec
汀: aafbm
汁: aafbd
求: bmafeca
汆: ecmhec
汇: aafb2
汈: aafuf
汉: aafhc
汊: aafhca
汐: aafeha
汔: aafebw
汕: aafd2d
汗: aafbbd
汛: aafwbd
汜: aafzbn
汝: aafieb
汞: bdbmhec
江: aafbdb
池: aafudn
污: aafbbx
汤: aafree
汨: aafdzbb
汩: aafdzbb
汪: aafbbdb
汭: aafduea
汰: aafbeca
汲: aafe6c
汴: aafabda
汶: aafabec
汹: aafea2d
汽: aafebbw
汾: aafecue
沁: aafaoaa
沂: aafeebd
沃: aafebec
沄: aafbb3a
沅: aafbben
沆: aafabew
沈: aafahen
沉: aafahew
沌: aafb2dn
沏: aafbjue
沐: aafbdec
沓: mhecdzbb
沔: aafbd2u
沘: aafbjen
沙: aafdeae
沚: aafdbdb
沛: aafbdud
沟: aafeu3a
没: aafeqhc
沣: aafbbbd
沤: aafbea2
沥: aafbeue
沦: aafecen
沧: aafecun
沨: aafewea
沩: aafaeua
沪: aafazbe
沫: aafbbdec
沭: aafbdeca
沮: aafdzbbb
沱: aafaahen
河: aafbdzbm
沸: aafzbxed
油: aafdzbdb
治: aaf3adzb
沼: aafuedzb
沽: aafbddzb
沾: aafdbdzb
沿: aafeqdzb
泃: aafeudzb
泄: aafbddb2
泅: aafdzeab
泉: edzbbmhec
泊: aafedzbb
泌: aafaoaea
泐: aafrdue
泓: aafzbx3a
泔: aafbddbb
法: aafbdb3a
泖: aafejeud
泗: aafdze2b
泚: aafdbdfen
泛: aafeahc
泜: aafejboa
泞: aafaahbm
泠: aafecaha
泡: aafeuzbn
波: aafhedhc
泣: aafabaeb
泥: aafzbeen
注: aafabbdb
泪: aafdzbbb
泫: aafab33a
泮: aafaebbd
泯: aafzbjbo
泰: bbbecmafea
泱: aafdzbec
泳: aafauhec
泵: bedzbmhec
泷: aafbenea
泸: aafdbzbe
泺: aafe2mea
泻: aafahbxb
泼: aaf3ehca
泽: aafhcbbd
泾: aafhabdb
洁: aafbdbdzb
洄: aafdzdzbb
洇: aafdzbeab
洋: aafaebbbd
洌: aafbehadm
洎: aafedzbbb
洑: aafedbeca
洒: aafbdze2b
洗: aafebdben
洙: aafebbdec
洚: aafehcb3d
洛: aafehcdzb
洞: aafdubdzb
洣: aafaebdec
津: aafzbbbbd
洧: aafbedubb
洨: aafabeaec
洪: aafbddbea
洫: aafedzddb
洮: aafeafnea
洱: aafbddbbb
洲: aafaeadad
洳: aafiebdzb
洴: aafaebbed
洵: aafeudzbb
洹: aafbdzbbb
洺: aafehadzb
活: aafebddzb
洼: aafbdbbdb
洽: aafecbdzb
派: aafeeejec
流: aafab3aedn
浃: aafbaebec
浅: aafbboea
浆: afdehamhec
浇: aafboeben
浈: aafdbdzea
浉: aafdebdud
浊: aafdzbdba
测: aafdzeadm
浍: aafecbb3a
济: aafabeced
浏: aafabeadm
浐: aafabaebe
浑: aafahb3bd
浒: aafakebbd
浓: aafahejec
浔: aafzbbbma
浕: aafzbecaa
浙: aafbmfeebd
浚: aaf3aeaehc
浜: aafedbdbea
浞: aafdzbdbec
浠: aafeabedud
浡: aafbdahhmb
浣: aafaahbben
浥: aafdzbzdbn
浦: aafbdubbda
浩: aafebdbdzb
浪: aafazbbjec
浮: aafeaaehmb
浯: aafbdzbdzb
浴: aafeaecdzb
海: aafeb2uaba
浸: aafzbbahhc
浼: aafehdzben
涂: aafecbbmea
涅: aafdzbbbdb
消: aafdaedubb
涉: aafdbdbdee
涌: aafhadubbd
涎: aafedb26c
涑: aafbdzbdec
涓: aafdzbdubb
涔: aafd2decah
涕: aafaezbxde
涘: aaf3aebbec
涛: aafbbbebma
涝: aafbddahue
涞: aafbaebdec
涟: aafb3bda6c
涠: aafdzbbudb
涡: aafdzbduea
涢: aafdzbdzea
涣: aafehdzbec
涤: aafehcbmea
润: aafadubbdb
涧: aafadudzbb
涨: aafzbxebjc
涩: aafueadbdb
涪: aafabaebdzb
涫: aafaahdzbzb
涮: aafzbeduddm
涯: aafbebdbbdb
液: aafabedehac
涵: aafhmafea2d
涸: aafdzbddzbb
涿: aafbeleeaec
淀: aafaahbdbec
淄: aafiiidzbdb
淅: aafbdeaeebd
淆: aafeabedubb
淇: aafbddbbbea
淋: aafbdeabdec
淌: aafdaedudzb
淏: aafdzbbbbec
淑: aafdbbmeahc
淖: aafdbdzbbbd
淘: aafeuebbd2d
淙: aafaahbbmea
淝: aafeubbzdbn
淞: aafbdeaec3a
淠: aafdzbdbbed
淡: aafaeeaaeec
淤: aafabueecaa
淦: aafecbbdaeb
淫: aafeaaeebdb
淬: aafabeaeabd
淮: aafedabbbdb
深: aafaheabdec
淳: aafabdzbhmb
混: aafdzbbbjen
淹: aafbecdzbbn
添: aafbbecmaaa
清: aafbbdbdubb
渊: aafeaebdead
渌: aafzbbmafec
渍: aafbbdbdzea
渎: aafbdhaabea
渐: aafb3dfeebd
渑: aafdzbdzbbn
渔: aafehdzbdbb
渗: aaf3abeceee
渚: aafbdbedzbb
渝: aafecbdubbdm
渠: aafbzb2bdec
渡: aafabebddbhc
渣: aafbdecdzbbb
渤: aafbdahhmfue
渥: aafzbeb3abdb
温: aafdzbbdzddb
渫: aafbddb2bdec
渭: aafdzbdbdubb
港: aafbddbeczbn
渲: aafaahbdzbbb
渴: aafdzbbeuea2
游: aafabueebhmb
渺: aafdzbbbdeae
湃: aafebbebbbbd
湄: aafzdbedzbbb
湉: aafaadebddzb
湍: aafd2dbedudd
湎: aafbedzddbbb
湔: aafaebdubbdm
湖: aafbddzbeubb
湘: aafbdeadzbbb
湛: aafbddbbbea2
湜: aafdzbbbdbec
湝: aafbjenedzbb
湟: aafedzbbbbdb
湨: aafdzbbbbeca
湫: aafebdeaaeec
湮: aafbdzddbbdb
湲: aafeaaebbehc
湾: aafabddeazbx
湿: aafdzbbddaeb
溃: aafdzbdbdzea
溅: aafdzeabboea
溆: aabeabbdeaza
溇: aafaebdecieb
溉: aafzbbjab3en
溏: aafabezbbddzb
源: aafbeedzbbmea
溘: aafbdb3adzddb
溜: aafejauedzbdb
溟: aafahdzbbabea
溠: aafaebbbebdb
溢: aafaebeadzddb
溥: aafbdzbbdabma
溦: aafd2dbekebec
溧: aafbdzddbbdec
溪: aafeaae33abec
溯: aafaeb2deeubb
溱: aafbbbecebdea
溲: aafedbzbbdhc
溴: aafedzbbbbeca
溶: aafaaheaecdzb
溷: aafdzbeleeeab
溺: aafzbxafzbxaf
溻: aafdzbbuafuaf
溽: aafbebbjecbma
滁: aafrdecbbmea
滂: aafabaeahabue
滃: aafec3auafuaf
滇: aafbddzbbbbea
滋: aafaeb33a33a
滍: aaf2ddbdzbdba
滏: aafeaecbbdaeb
滑: aafdzzahdubb
滓: aafaahabaebbd
滔: aafeaaeedbzbb
滕: eubbaebbecmafea
滗: aafebaebaebbn
滘: aafaheabdbdzb
滚: aafabea3aejec
滞: aafbdddahdud
滟: aafbbbdehzdbn
滠: aafbddbbbhahc
满: aafbddbdueaea
滢: aafbddahbbdba
滤: aafdbhebnaoaa
滥: aafddebadzddb
滦: aafabddeabdec
滨: aafaahedbdbea
滩: aafhaedabbbdb
滪: aafhahmbedzea
滫: aafeddehcdubb
滴: aafabaedubddzb
滹: aafdbhebneaebm
漂: aafbdzddbbbmea
漆: aafbdeaecmafea
漉: aafabezddbbjen
漏: aafzbebdudaaaa
漓: aafabea2ddu3a
演: aafaahbdzbdbea
漕: aafbdzbddbdzbb
漠: aafbdddzbbbec
漤: aafbdeabdecieb
漩: aafabueebhdbec
漪: aafelebeabdzbm
漫: aafdzbbdzddbhc
漭: aafbddbecabed
漯: aafdzbdb33amea
漱: aafbdzbdeaehec
漳: aafabaebdzbbbd
漶: aafdzbdzbdaoaa
漾: aafaebbdbauhec
潆: aafbddah33amea
潇: aafbddzbbdedea
潋: aafeabaaefebec
潍: aaf33fedabbbdb
潏: aafhahmedueadzb
潘: aafeaebdecdzbdb
潜: aafbbeabbecdzbb
潞: aafdzbdbdfehcdzb
潟: aafedbzbbeuaaaa
潢: aafbddbdzbdbea
潦: aafbecaedzbbmea
潭: aafbdzddbdzbbbd
潮: aafbddzbbbdeubb
潲: aafebdeadaedubb
潴: aafelebdbedzbb
潵: aafbddbdubbebec
潸: aafbdeabdecdubb
潺: aafzbehmbhmfhmb
潼: aafabaebdzbbdbb
潽: aafaebddaebdzbb
澄: aafhaeecbdzbaeb
澈: aafab3adubbebec
澉: aafhbddbbfebec
澌: aafbddbbbeaeebd
澍: aafbdbdzbaefbma
澎: aafbdbdzbaefeee
澜: aafadubdzaebdea
澡: aafdzbdzbdzbbdec
澥: aafeheubbdueebbd
澧: aafdzbddbbdzbaeb
澳: aafedzaebdeabec
澴: aafdzddbbdzbejec
澶: aafabdzdzbbdzbbb
澹: aafehbeeaabbbdzb
澼: aafzbedzbabaebbd
激: aafedzbbabueebec
濂: aafabeaebzbbddec
濉: aafdzbbbedabbbdb
濑: aafbdzbdeaehdzea
濒: aafdbdbdeebedzea
濞: aafedzbbbdzbdbbed
濠: aafabdzbahbeleeec
濡: aafbahdaaaabedudd
濮: aafedddaebaebbbec
濯: aafzafzafedabbbdb
瀌: aafabezddbbjbnaaaa
瀍: aafabedzbbdbbeabdb
瀑: aafdzbbbddbecmafea
瀚: aafbddzbbbdecuafuaf
瀛: aafab2dzbeubbiebewa
瀣: aafdbehahcdbbbdbbbb
瀵: aafaebdecdzbdbbddbea
瀹: aafecbdzbdzbdzbdubdd
灌: aafbdddzbdzbedabbbdb
灏: aafdzbbabdzbmeabedzea
灞: aafbahdaaaabddbdzbbdeubb
火: aeec
灭: baeec
灯: aeeabm
灰: beaeec
灵: zbbaeec
灶: aeeabdb
灸: ehaaeec
灼: aeeaeua
灾: aahaeec
灿: aeead2d
炀: aeea7ee
炅: dzbbaeec
炉: aeeaazbe
炊: aeeaehec
炎: aeeaaeec
炒: aeeadeae
炔: aeeazbec
炕: aeeaabew
炖: aeeab2dn
炙: ehaaaeec
炜: aeeabbud
炝: aeeaecun
炟: aeeadzbbb
炫: aeeaab33a
炬: aeeabzb2
炭: d2dbeaeec
炮: aeeaeuzbn
炯: aeeadudzb
炱: 3adzbaeec
炳: aeeabduea
炷: aeeaabbdb
炸: aeeaebdbb
点: dbdzbaaaa
炻: aeeabedzb
炼: aeeab3uea
炽: aeeadzbaa
烀: aeeaeaebm
烁: aeeae2mea
烂: aeeaaebbb
烃: aeeahabdb
烈: behadmaaaa
烊: aeeaaebbbd
烘: aeeabddbea
烙: aeeaehcdzb
烛: aeeadzbdba
烜: aeeabdzbbb
烝: hmhecbaaaa
烟: aeeadzbeab
烤: aeeabdbebx
烦: aeeabedzea
烧: aeeaboeben
烨: aeeaedenbd
烩: aeeaecbb3a
烫: aafreeaeec
烬: aeeazbecaa
热: bmfewaaaaa
烯: aeeaeabedud
烷: aeeaaahbben
烹: abdzbhmaaaa
烺: aeeaazbbjec
烽: aeeaehcbbbd
焉: bdbdbbxaaaa
焊: aeeadzbbbbd
焌: aeea3aeaehc
焐: aeeabdzbdzb
焓: aeeaecahdzb
焕: aeeaehdzbec
焖: aeeaaduaoaa
焘: bbbebmaaaaa
焙: aeeaabaebdzb
焚: bdeabdeaaeec
焜: aeeadzbbbjen
焦: edabbbdbaaaa
焯: aeeadbdzbbbd
焰: aeeaehedbzbb
焱: aeecaeeaaeec
然: ehaabecaaaaa
煅: aeeaedbbfeqhc
煊: aeeaaahbdzbbb
煌: aeeaedzbbbbdb
煎: aebdubbdmaaaa
煜: aeeadzbbabaeb
煞: ehzbbebecaaaa
煤: aeeabddbbbdec
煦: dzbbeudzbaaaa
照: dzbbuedzbaaaa
煨: aeeadzbdbbjec
煮: bdbedzbbaaaa
煲: eddzbbdeaaeec
煳: aeeabddzbeubb
煸: aeeaazbedubdd
煺: aeeazbbjeaa6c
煽: aeeaazbeuafuaf
熄: aeeaedzbbbaoaa
熊: 3adubbenenaaaa
熏: ebdzaebdbbaaaa
熔: aeeaaaheaecdzb
熘: aeeaejauedzbdb
熙: bddzbd2zbnaaaa
熜: aeeaedzehabaoaa
熟: abdzbhmfewaaaaa
熠: aeeazafzafedzbb
熥: aeeahadubbda6c
熨: zbebbmeabmaaeec
熬: bbdbueebecaaaa
熵: aeeaabaedueadzb
熹: bdbdzbaebdzbaaaa
燃: aeeaehaabecaaaaa
燊: aeeaaeeaaeeabdec
燎: aeeabecaedzbbmea
燏: aeeahahmedueadzb
燔: aeeaeaebdecdzbdb
燕: bddbdzbdbfenaaaa
燠: aeeaedzaebdeabec
燥: aeeadzbdzbdzbbdec
燧: aeeaaebeleeeaa6c
燮: abbbdzbaeeaaeeahc
燹: beleeeabeleeeaaeec
爆: aeeadzbbbddbecmafea
爝: aeeaeaaedzddbzbbjabma
爨: edbbdzbdzbzbbahbdeabdeabecaeea
爪: eedc
爬: eedczdbn
爰: eaaebbehc
爱: eaaeahbehc
爵: eaaedzddbzbbjabma
父: eaec
爷: eaecud
爸: eaeczdbn
爹: eaecehaeha
爻: eaec
爽: beaeaeaeaec
爿: 2dbe
牁: 2dbebdzbm
牂: 2dbeaebbbd
片: edbz
版: edbzeehc
牌: edbzedzbbebd
牍: edbzbdhaabea
牒: edbzbddb2bdec
牖: edbzazbebdubbda
牙: b3me
牚: daeahdzbb3me
牛: ebbd
牝: ebdfen
牟: 3aebbd
牡: ebdfbdb
牢: aahebbd
牦: ebdfebbn
牧: ebdfebec
物: ebdfeuee
牮: edboaebbd
牯: ebdfbddzb
牲: ebdfebbdb
牵: beaahebbd
特: ebdfbdbbma
牺: ebdfbdze2b
牾: ebdfbdzbdzb
犀: zbedafeaebbd
犁: ebdeadmebbd
犄: ebdfbeabdzbm
犊: ebdfbdhaabea
犋: ebdfdzbbbbea
犍: ebdfzbbbbd6c
犏: ebdfazbedubdd
犒: ebdfabdzbdudzb
犟: zbxdzbdzbdbaebbd
犨: edabbbdbedabbbdbebbd
犬: beca
犯: eleun
犰: eleew
犴: elebbd
状: afdbeca
犷: eleabe
犸: elezxb
犹: elebena
狁: ele3aen
狂: elebbdb
狃: elezdbb
狄: eleaeec
狈: eledzea
狉: elebedab
狍: eleeuzbn
狎: eledzbbd
狐: eleeejac
狒: elezbxed
狗: eleeudzb
狙: eledzbbb
狝: eleehmea
狞: eleaahbm
狠: elezbbjec
狡: eleabeaec
狨: elebbeoea
狩: eleaahbma
独: eledzbdba
狭: elebaebec
狮: eledebdud
狯: eleecbb3a
狰: eleehzbbm
狱: eleakbeca
狲: elehmfmea
狳: eleecbbmea
狴: elebjenbdb
狷: eledzbdubb
狸: eledzbbdbb
狺: eleabbbdzb
狻: ele3aeaehc
狼: eleazbbjec
猁: eleebdeadm
猃: eleecbaaeb
猄: eleabdzbmea
猊: eleedbzbben
猎: elebddbdzbb
猕: elezbxehmea
猖: eledzbbdzbb
猗: elebeabdzbm
猛: elehmbdzddb
猜: elebbdbdubb
猝: eleabeaeabd
猞: eleecbbddzb
猡: eledzddbeha
猢: elebddzbeubb
猥: eledzbdbbjec
猩: eledzbbebbdb
猪: elebdbedzbb
猫: elebdddzbdb
猬: eledzbdbdubb
献: bdduaebbdbeca
猱: elehahmebdec
猴: eleedzbebbec
猷: aebdze2bbbeca
猸: elezdbedzbbb
猹: elebdecdzbbb
猾: eledzzahdubb
猿: elebdbdzbejec
獍: eleabaebdzbben
獐: eleabaebdzbbbd
獒: bbdbueebeabeca
獗: elebeaeb2deehec
獠: elebecaedzbbmea
獬: eleeheubbdueebbd
獭: elebdzbdeaehdzea
獯: eleebdzaebdbbaaaa
獴: elebddahbbeleeec
獾: elebdddzbdzbedabbbdb
玄: ab33a
率: ab33aafeabd
玉: bbdba
王: bbdb
玎: bbdfbm
玑: bbdfew
玕: bbdfbbd
玖: bbdfehc
玙: bbdfbxb
玚: bbdf7ee
玛: bbdfzxb
玠: bbdfeced
玡: bbdfb3me
玢: bbdfecue
玥: bbdfeubb
玦: bbdfzbec
玩: bbdfbben
玫: bbdfebec
玮: bbdfbbud
环: bbdfbeda
现: bbdfdzen
玲: bbdfecaha
玳: bbdfedboa
玷: bbdfdbdzb
玺: ehmeabbdba
玻: bbdfhedhc
珀: bbdfedzbb
珂: bbdfbdzbm
珈: bbdfuedzb
珉: bbdfzbjbo
珊: bbdfeueub
珍: bbdfeceee
珏: bbdfbbdba
珐: bbdfbdb3a
珑: bbdfbenea
珙: bbdfbddbea
珞: bbdfehcdzb
珠: bbdfebbdec
珣: bbdfeudzbb
珥: bbdfbddbbb
珧: bbdfeafnea
珩: bbdfeedbbm
班: bbdfaebbdb
珰: bbdfdaezbb
珲: bbdfahb3bd
珽: bbdfebdb6c
球: bbdfbmafeca
琅: bbdfazbbjec
理: bbdfdzbbdbb
琇: bbdfebdecre
琉: bbdfab3aedn
琎: bbdfbbeda6c
琏: bbdfb3bda6c
琐: bbdfdaedzea
琚: bbdfzbebddzb
琛: bbdfaheabdec
琢: bbdfbeleeaec
琤: bbdfehzbbm
琥: bbdfdbhebnew
琦: bbdfbeabdzbm
琨: bbdfdzbbbjen
琪: bbdfbddbbbea
琫: bbdfbbbecbbd
琬: bbdfaahehaun
琮: bbdfaahbbmea
琯: bbdfaahdzbzb
琰: bbdfaeeaaeec
琳: bbdfbdeabdec
琴: bbdbbbdbecah
琵: bbdbbbdbbjen
琶: bbdbbbdbzdbn
琼: bbdfabdzbmea
瑀: bbdfedzbdudfa
瑁: bbdfdzbbdzbbb
瑄: bbdfaahbdzbbb
瑕: bbdfzbdbbzbhc
瑗: bbdfeaaebbehc
瑙: bbdfiiiedzeab
瑚: bbdfbddzbeubb
瑛: bbdfbdddzbec
瑜: bbdfecbdubbdm
瑞: bbdfd2dbedudd
瑟: bbdbbbdbaoaea
瑢: bbdfaaheaecdzb
瑭: bbdfabezbbddzb
瑰: bbdfedzbben3a
瑶: bbdfeaaeebbd2d
瑾: bbdfbddbdzbbbdb
璀: bbdfd2dedabbbdb
璁: bbdfedzehabaoaa
璃: bbdfabea2ddu3a
璆: bbdfzafzafeceee
璇: bbdfabueebhdbec
璈: bbdfbbdbueebec
璋: bbdfabaebdzbbbd
璎: bbdfdzeadzeaieb
璐: bbdfdzbdbdfehcdzb
璘: bbdfaebdecehab3d
璜: bbdfbddbdzbdbea
璞: bbdfddaebaebbbec
璟: bbdfdzbbabdzbmea
璠: bbdfeaebdecdzbdb
璧: zbedzbabaebbdbbdba
璨: bbdfdbehahaaebdec
璩: bbdfdbhebnbeleeec
璪: bbdfdzbdzbdzbbdec
瓒: bbdfebdbejebdbendzea
瓘: bbdfbdddzbdzbedabbbdb
瓜: eejac
瓞: eejacebbea
瓠: becbbxeejac
瓢: bdzddbbbmeaeejac
瓣: abaebbeeejacabaebbd
瓤: abdzbdzbbbddbejeaeejac
瓦: bjwa
瓮: ec3abjwa
瓯: bea2bjwa
瓴: eaahabjwa
瓶: aebbedbjwa
瓷: afehecbjwa
瓻: eabedudbjwa
瓿: abaebdzbbjwa
甄: bdzddbbdfbjwa
甍: bdddzddbahbjwa
甏: bdbdzbaefeeebjwa
甑: aedzdaebdzbbbjwa
甓: zbedzbabaebbdbjwa
甘: bddbb
甙: bbddbboa
甚: bddbbbea2
甜: ebddzbbddbb
生: ebbdb
甥: ebbdfdzbdbue
用: eubbd
甩: eubbn
甪: eeubbd
甫: bdubbda
甬: hadubbd
甭: bedaeubbd
田: dzbdb
由: dzbdb
甲: dzbbd
申: dzbbd
电: dzbbn
男: dzbdbue
甸: eudzbdb
町: dzbdbbm
画: bdzbdb2d
甾: iiidzbdb
畀: dzbdbbed
畅: dzbbdree
畈: dzbdbeehc
畋: dzbdbebec
界: dzbdbeced
畎: dzbdbbeca
畏: dzbdbbjec
畔: dzbdbaebbd
留: ejauedzbdb
畚: 3abecdzbdb
畛: dzbdbeceee
畜: ab33adzbdb
略: dzbdbehcdzb
畦: dzbdbbdbbdb
番: eaebdecdzbdb
畯: dzbdb3aeaehc
畲: ecbbmeadzbdb
畴: dzbdbbbbebma
畸: dzbdbbeabdzbm
畹: dzbdbaahehaun
畿: 33a33abdzbdboea
疃: dzbdbabaebdzbbdbb
疆: zbxbdfbdzbdbbdzbdbb
疍: hdbecdzbbb
疏: hdbdfab3aedn
疑: enebbeahahdbec
疔: abeafbm
疖: abeafud
疗: abeafhm
疙: abeafebw
疚: abeafehc
疝: abeafd2d
疟: abeafb2b
疠: abeafbue
疡: abeafree
疢: abeafaeec
疣: abeafbena
疤: abeafzdbn
疥: abeafeced
疫: abeafeqhc
疬: abeafbeue
疭: abeafeaec
疮: abeafecun
疯: abeafewea
疰: abeafabbdb
疱: abeafeuzbn
疲: abeafhedhc
疳: abeafbddbb
疴: abeafbdzbm
疵: abeafdbdfen
疸: abeafdzbbb
疹: abeafeceee
疼: abeafehcaa
疽: abeafdzbbb
疾: abeafebbec
痂: abeafuedzb
痃: abeafab33a
痄: abeafebdbb
病: abeafbduea
症: abeafbdbdb
痈: abeafeubbd
痉: abeafhabdb
痊: abeafecbbdb
痍: abeafbzbxec
痒: abeafaebbbd
痔: abeafbdbbma
痕: abeafzbbjec
痘: abeafbdzbaeb
痛: abeafhadubbd
痞: abeafbedadzb
痢: abeafebdeadm
痣: abeafbdbaoaa
痤: abeafeaeabdb
痦: abeafbdzbdzb
痧: abeafaafdeae
痨: abeafbddahue
痪: abeafehdzbec
痫: abeafadubdea
痰: abeafaeeaaeec
痱: abeafdbbbdbbb
痴: abeafebbeadzb
痹: abeafdzbdbbed
痼: abeafdzbddzbb
痿: abeafebdecieb
瘁: abeafabeaeabd
瘃: abeafbeleeaec
瘅: abeafaedzbbbd
瘆: abeaf3abeceee
瘊: abeafedzbebbec
瘌: abeafbdzbdeadm
瘐: abeafedbzbbec
瘗: abeafbaebecbdb
瘘: abeafaebdecieb
瘙: abeafhcadzbdba
瘛: abeafbbbdueaoaa
瘟: abeafdzbbdzddb
瘠: abeafafeaecdubb
瘢: abeafeeuabaeqhc
瘤: abeafejauedzbdb
瘥: abeafaebbbebdb
瘦: abeafedbzbbdhc
瘩: abeafbddecbdzb
瘪: abeafedzbbbecen
瘫: abeafhaedabbbdb
瘭: abeafbdzddbbbmea
瘰: abeafdzbdb33amea
瘳: abeafzafzafeceee
瘴: abeafabaebdzbbbd
瘵: abeafehaahcbbmea
瘸: abeafuedzbdueaea
瘼: abeafbdddzbbbec
瘾: abeafrdehzbbaoaa
瘿: abeafdzeadzeaieb
癀: abeafbddbdzbdbea
癃: abeafrdehcbebbdb
癌: abeafdzbdzbdzbd2d
癍: abeafbbdfabeabbdb
癔: abeafabaebdzbbaoaa
癖: abeafzbedzbabaebbd
癜: abeafzbebddbeaeqhc
癞: abeafbdzbdeaehdzea
癣: abeafehdzbdbfaebbbd
癫: abeafbddzbbbbeabedzea
癯: abeafdzbbbdzbbbedabbbdb
癸: haeecbbea
登: haeecbdzbaeb
白: edzbb
百: bedzbb
皂: edzbbbn
的: edzbbeua
皆: bjenedzbb
皇: edzbbbbdb
皈: edzbbeehc
皋: edzbbbecbd
皎: edzbbabeaec
皑: edzbbd2dzbn
皓: edzbbebdbdzb
皖: edzbbaahbben
皤: edzbbeaebdecdzbdb
皮: hedhc
皱: ehzbbhedhc
皲: ahb3dfhedhc
皴: 3aeaehahedhc
皿: dzddb
盂: bbmdzddb
盅: dzbddzddb
盆: ecuedzddb
盈: rehadzddb
盉: ebdecdzddb
益: aebeadzddb
盍: bdb3adzddb
盎: dzbecdzddb
盏: bboeadzddb
盐: bdfdadzddb
监: ddebadzddb
盒: ecbdzbdzddb
盔: beaeecdzddb
盖: aebbdbdzddb
盗: afehecdzddb
盘: eeuabadzddb
盛: beuoeadzddb
盟: dzbbeubbdzddb
盥: edbbmheazbbdzddb
盦: ecahbdze2bbdzddb
目: dzbbb
盯: dzbbbbm
盱: dzbbbbbm
盲: ab2dzbbb
直: bddzbbbb
相: bdeadzbbb
盹: dzbbbb2dn
盼: dzbbbecue
盾: eebddzbbb
省: deaedzbbb
眄: dzbbbbd2u
眇: dzbbbdeae
眈: dzbbbahen
眉: zdbedzbbb
眊: dzbbbebbn
看: ebbedzbbb
眍: dzbbbbea2
眙: dzbbb3adzb
眚: ebbdbdzbbb
真: bddzbbbbea
眠: dzbbbzbjbo
眢: ehaundzbbb
眦: dzbbbdbdfen
眨: dzbbbeahc
眩: dzbbbab33a
眬: dzbbbbenea
眭: dzbbbbdbbdb
眯: dzbbbaebdec
眵: dzbbbehaeha
眶: dzbbbbbbdb2
眷: aebbecdzbbb
眸: dzbbb3aebbd
眺: dzbbbeafnea
眼: dzbbbzbbjec
着: aebbbedzbbb
睁: dzbbbehzbbm
睃: dzbbb3aeaehc
睇: dzbbbaezbxde
睐: dzbbbbaebdec
睑: dzbbbecbaaeb
睚: dzbbbbebdbbdb
睛: dzbbbbbdbdubb
睡: dzbbbebdbddbb
睢: dzbbbedabbbdb
督: dbbdeahcdzbbb
睥: dzbbbedzbbebd
睦: dzbbbbdbeabdb
睨: dzbbbedbzbben
睫: dzbbbbzbbdbec
睬: dzbbbeaaebdec
睹: dzbbbbdbedzbb
睽: dzbbbhaeecbbea
睾: edzddbbdbaebbd
睿: dbahbeaecdzbbb
瞀: hahmeebecdzbbb
瞄: dzbbbbdddzbdb
瞅: dzbbbebdeaaeec
瞌: dzbbbbdb3adzddb
瞍: dzbbbedbzbbdhc
瞎: dzbbbaahbbbddzb
瞑: dzbbbahdzbbabea
瞒: dzbbbbddbdueaea
瞟: dzbbbbdzddbbbmea
瞠: dzbbbdaeahdzbbdb
瞢: bdddzddbahdzbbb
瞥: aedudeaebecdzbbb
瞧: dzbbbedabbbdbaaaa
瞩: dzbbbzbeedzbdudfa
瞪: dzbbbhaeecbdzbaeb
瞬: dzbbbeaaeahehab3d
瞭: dzbbbbecaedzbbmea
瞰: dzbbbhbddbbfebec
瞳: dzbbbabaebdzbbdbb
瞵: dzbbbaebdecehab3d
瞻: dzbbbehbeeaabbbdzb
瞽: bdbdzbaefbdhcdzbbb
瞿: dzbbbdzbbbedabbbdb
矍: dzbbbdzbbbedabbbdbhc
矗: bddzbbbbbddzbbbfbddzbbbb
矛: hahme
矜: hahmeecah
矢: ebbec
矣: 3aebbec
知: ebbeadzb
矧: ebbeazbxd
矩: ebbeabzb2
矫: ebbeaebeced
矬: ebbeaeaeabdb
短: ebbeabdzbaeb
矮: ebbeaebdecieb
石: bedzb
矶: bedzbew
矸: bedzbbbd
矻: bedzbebw
矽: bedzbeha
矾: bedzbewa
矿: bedzbabe
砀: bedzbree
码: bedzbzxb
砂: bedzbdeae
砉: bbbdbedzb
砌: bedzbbjue
砍: bedzbehec
砑: bedzbb3me
砒: bedzbbjen
研: bedzbbbed
砖: bedzbbb5a
砗: bedzbb3bd
砘: bedzbb2dn
砚: bedzbdzen
砜: bedzbewea
砝: bedzbbdb3a
砟: bedzbebdbb
砣: bedzbaahen
砥: bedzbejboa
砧: bedzbdbdzb
砭: bedzbeahc
砮: iebhcbedzb
砰: bedzbbaebd
破: bedzbhedhc
砷: bedzbdzbbd
砸: bedzbbdud2
砹: bedzbbddec
砺: bedzbbebue
砻: beneabedzb
砼: bedzbecbdb
砾: bedzbe2mea
础: bedzb2dd2d
硁: bedzbhabdb
硅: bedzbbdbbdb
硇: bedzbedzeab
硌: bedzbehcdzb
硎: bedzbbbeddm
硐: bedzbdubdzb
硒: bedzbbdze2b
硕: bedzbbedzea
硖: bedzbbaebec
硗: bedzbboeben
硚: bedzbebeced
硝: bedzbdaedubb
硪: bedzbebmfoea
硫: bedzbab3aedn
硬: bedzbbdzbbec
硭: bedzbbddab2
确: bedzbeheubbd
硷: bedzbecbaaeb
硼: bedzbeubbeubb
碇: bedzbaahbdbec
碉: bedzbeubdbdzb
碌: bedzbzbbmafec
碍: bedzbdzbbbbma
碎: bedzbabeaeabd
碑: bedzbedzbbebd
碓: bedzbedabbbdb
碗: bedzbaahehaun
碘: bedzbdzbddbea
碚: bedzbabaebdzb
碛: bedzbbbdbdzea
碜: bedzb3abeceee
碟: bedzbbddb2bdec
碡: bedzbbbdb2uaba
碣: bedzbdzbbeuea2
碥: bedzbazbedubdd
碧: bbdfedzbbbedzb
碰: bedzbaebddaeb
碱: bedzbbebdzboea
碲: bedzbabaeahdud
碳: bedzbd2dbeaeec
碴: bedzbbdecdzbbb
碶: bedzbbbbduebec
碹: bedzbaahbdzbbb
碾: bedzbzbebddbjec
磁: bedzbaeb33a33a
磅: bedzbabaeahabue
磉: bedzbhahahabdec
磊: bedzbbedzbbedzb
磋: bedzbaebbbebdb
磐: eeuabaeqhcbedzb
磔: bedzbehab3dbdec
磕: bedzbbdb3adzddb
磙: bedzbabea3aejec
磨: abebdeabdecbedzb
磬: bdbzdbeeqhabedzb
磲: bedzbaafbzb2bdec
磴: bedzbhaeecbdzbaeb
磷: bedzbaebdecehab3d
磺: bedzbbddbdzbdbea
礁: bedzbedabbbdbaaaa
礅: bedzbabdzbhmfebec
礌: bedzbbahdaaaadzbdb
礓: bedzbbdzbdbbdzbdbb
礞: bedzbbddahbbeleeea
礤: bedzbbddehaahcbbmea
礳: bedzbabebdeabdecbedzb
礴: bedzbbddaafbdzbbdabma
示: bbmea
礼: ahdan
社: ahdabdb
祀: ahdazbn
祁: ahdard
祃: ahdazxb
祆: ahdabbec
祈: ahdaeebd
祉: ahdadbdb
祎: ahdabbud
祓: ahdabehca
祖: ahdadzbbb
祗: ahdaejboa
祚: ahdaebdbb
祛: ahdabdb3a
祜: ahdabddzb
祝: ahdadzben
神: ahdadzbbd
祟: 2dd2dbbmea
祠: ahdaubdzb
祢: ahdaehmea
祥: ahdaaebbbd
祧: ahdaeafnea
票: bdzddbbbmea
祭: ehaahcbbmea
祯: ahdadbdzea
祲: ahdazbbahhc
祷: ahdabbbebma
祸: ahdadzbduea
祺: ahdabddbbbea
祼: ahdadzbbbdec
祾: ahdabdbeaehc
禀: abdzdzbbbbmea
禁: bdeabdecbbmea
禄: ahdazbbmafec
禅: ahdaaedzbbbd
禊: ahdabbbduebec
福: ahdabdzbdzbdb
禚: ahdaaebbdbaaaa
禤: ahdadzddbuafuaf
禧: ahdabdbdzbaebdzb
禳: ahdaabdzbdzbbbddbejec
禹: edzbdudfa
禺: dzbbdudfa
离: abea2ddu3a
禽: ecabea2ddu3a
禾: ebdec
秀: ebdecre
私: ebdea3a
秃: ebdecew
秆: ebdeabbd
秉: ebzbbdec
秋: ebdeaaeec
种: ebdeadzbd
科: ebdeaaabd
秒: ebdeadeae
秕: ebdeabjen
秘: ebdeaaoaea
租: ebdeadzbbb
秣: ebdeabbdec
秤: ebdeabaebd
秦: bbbecebdea
秧: ebdeadzbec
秩: ebdeaebbec
秫: ebdeabdeca
秭: ebdeaexde
积: ebdeadzbea
称: ebdeaehmea
秸: ebdeabdbdzb
移: ebdeaehaeha
秽: ebdead2deha
秾: ebdeaahejec
稀: ebdeaeabedud
稂: ebdeaazbbjec
稃: ebdeaeaaehmb
稆: ebdeadzbdzb
程: ebdeadzbbbdb
稍: ebdeadaedubb
税: ebdeaaedzben
稔: ebdeaecahaoaa
稗: ebdeaedzbbebd
稚: ebdeaedabbbdb
稞: ebdeadzbbbdec
稠: ebdeaeubdbdzb
稣: ehdzbdbfebdec
稳: ebdeaehzbbaoaa
稷: ebdeadzbdbeaehc
稻: ebdeaeaaeedbzbb
稼: ebdeaaahbeleeec
稽: ebdeabenaendzbb
稿: ebdeaabdzbdudzb
穄: ebdeaehaahcbbmea
穆: ebdeaedzbbdeaeee
穑: ebdeabdaebdzdzbb
穗: ebdeabdzbbdbaaoaa
穰: ebdeaabdzbdzbbbddbejec
穴: aahec
究: aaheaew
穷: aaheaue
穸: aaheaeha
穹: aaheazbx
空: aaheabdb
穿: aaheab3me
窀: aaheab2dn
突: aaheabeca
窃: aaheabjue
窄: aaheaebdbb
窅: aaheadzbbb
窈: aahea33aue
窍: aaheabdfbx
窑: aaheaebbd2d
窒: aaheab3abdb
窕: aaheaeafnea
窖: aaheaebdbdzb
窗: aaheaedzehab
窘: aaheazbbedzb
窜: aaheadzbdzbd
窝: aaheadzbduea
窟: aaheazbe2dd2d
窠: aaheadzbbbdec
窣: aaheaabeaeabd
窥: aaheabbeadzen
窦: aaheabdhaabea
窨: aaheaabaebdzbb
窬: aaheaecbdubbdm
窭: aaheaaebdecieb
窳: aaheaeejaaeejac
窸: aaheaeaebdecaoaa
窿: aaheardehcbebbdb
立: abaeb
竑: abaefbe3a
竖: ddhcabaeb
站: abaefdbdzb
竞: abaebdzben
竟: abaebdzbben
章: abaebdzbbbd
竣: abaef3aeaehc
童: abaebdzbbdbb
竦: abaefbdzbdec
竭: abaefdzbbeuea2
端: abaefd2dbedudd
竹: ebdebm
竺: ebaebabb
竽: ebaebabbm
竿: ebaebabbd
笃: ebaebazxb
笄: ebaebabbed
笆: ebaebazdbn
笈: ebaebae6c
笊: ebaebaeedc
笋: ebaebazbbe
笏: ebaebaeuee
笑: ebaebaebec
笔: ebaebaebbn
笕: ebaebadzen
笙: ebaebaebbdb
笛: ebaebadzbdb
笞: ebaeba3adzb
笠: ebaebaabaeb
笤: ebaebauedzb
笥: ebaebaubdzb
符: ebaebaedbma
笨: ebaebabdecb
笪: ebaebadzbbb
笫: ebaebaexde
第: ebaebazbxde
笮: ebaebaebdbb
笱: ebaebaeudzb
笳: ebaebauedzb
笸: ebaebabdzb2
笺: ebaebabboea
笼: ebaebabenea
笾: ebaebauea6c
筅: ebaebaebdben
筇: ebaebabdfrd
等: ebaebabdbbma
筋: ebaebaeubbue
筌: ebaebaecbbdb
筏: ebaebaedboea
筐: ebaebabbbdb2
筑: ebaebabdfewa
筒: ebaebadubdzb
答: ebaebaecbdzb
策: ebaebabdudec
筘: ebaebabmfdzb
筚: ebaebabjenbd
筛: ebaebadebdud
筜: ebaebadaezbb
筝: ebaebaehzbbm
筠: ebaebabdfeuaf
筢: ebaebabmfzdbn
筮: ebaebabdeaeab
筱: ebaebaeddebec
筲: ebaebadaedubb
筵: ebaebaedb26c
筷: ebaebaaadzbec
筹: ebaebabbbebma
筻: ebaebabdzbbec
筼: ebaebadzbdzea
签: ebaebaecbaaeb
简: ebaebaadudzbb
箅: ebaebadzbdbbed
箍: ebaebabmfbdud2
箐: ebaebabbdbdubb
箓: ebaebazbbmafec
箔: ebaebaaafedzbb
箕: ebaebabddbbbea
算: ebaebadzbbbbed
箜: ebaebaaaheabdb
管: ebaebaaahdzbzb
箢: ebaebaaahehaun
箦: ebaebabbdbdzea
箧: ebaebabbaebea2
箨: ebaebabmfhcbbd
箩: ebaebadzddbeha
箪: ebaebaaedzbbbd
箫: ebaebazbbdedea
箬: ebaebabddbedzb
箭: ebaebaaebdubbdm
箱: ebaebabdeadzbbb
箴: ebaebabebdzboea
箸: ebaebabdbedzbb
篁: ebaebaedzbbbbdb
篆: ebaeba3hbeleeec
篇: ebaebaazbedubdd
篌: ebaebaedzbebbec
篑: ebaebadzbdbdzea
篓: ebaebaaebdecieb
篙: ebaebaabdzbdudzb
篚: ebaebabdbbbdbbb2
篝: ebaebabbddbdudbb
篡: ebaebadzbbbbec3a
篥: ebaebabdzddbbdec
篦: ebaebaedzeabbjen
篪: ebaebaeedbhebnew
篮: ebaebaddebadzddb
篱: ebaebaabea2ddu3a
篷: ebaebaehcbbbda6c
篼: ebaebaedzbbejzben
篾: ebaebadzddbbeaoea
簃: ebaebaebdeaehaeha
簇: ebaebaabueebebbec
簉: ebaebaebdbdzba6c
簋: ebaebazbbjecdzddb
簌: ebaebabdzbdeaehec
簏: ebaebaabezddbbjen
簖: ebaebaaebdea2eebd
簟: ebaebabdzddbdzbbbd
簠: ebaebabdzbbdadzddb
簦: ebaebahaeecbdzbaeb
簧: ebaebabddbdzbdbea
簪: ebaebab3ejb3endzbb
簸: ebaebabddbbbeahedhc
簿: ebaebaaafbdzbbdabma
籀: ebaebabmfejauedzbdb
籁: ebaebabdzbdeaehdzea
籍: ebaebabbbdeabddbdzbb
米: aebdec
籴: ecaebdec
类: aebdeabec
籼: aebdead2d
籽: aebdeahmb
粉: aebdeaecue
粑: aebdeazdbn
粒: aebdeaabaeb
粕: aebdeaedzbb
粗: aebdeadzbbb
粘: aebdeadbdzb
粜: 2dd2daebdec
粝: aebdeabebue
粞: aebdeabdze2b
粟: bdzddbaebdec
粤: edzaebdeabbx
粥: zbxaebdeazbx
粪: aebdecbddbea
粮: aebdeaazbbjec
粱: aafueaaaebdec
粲: dbehahaaebdec
粳: aebdeabdzbbec
粹: aebdeaabeaeabd
粼: aebdeaehab3dii
粽: aebdeaaahbbmea
精: aebdeabbdbdubb
糁: aebdea3abeceee
糅: aebdeahahmebdec
糇: aebdeaedzbebbec
糈: aebdeahdbecdubb
糊: aebdeabddzbeubb
糌: aebdeaehcdadzbb
糍: aebdeaaeb33a33a
糕: aebdeaaebbdbaaaa
糖: aebdeaabezbbddzb
糗: aebdeaedzbbbbeca
糙: aebdeaebdbdzba6c
糜: abebdeabdecaebdec
糟: aebdeabdzbddbdzbb
糠: aebdeaabezbbmafec
糨: aebdeazbxdzbdzbdba
糯: aebdeabahdaaaabedudd
糵: bddedzbzbabaebbdaebdec
系: e33amea
紊: abec33amea
素: bbdb33amea
索: bdah33amea
紧: ddhc33amea
紫: dbdfen33amea
累: dzbdb33amea
絮: iebdzb33amea
絷: bmfewa33amea
綦: bddbbbec33amea
綮: azbeebec33amea
縻: abebdeabdec33amea
繁: eb2uabaebec33amea
繄: bebbea2eqhc33amea
繇: eaaeebbd2de33amea
纂: ebaebadzbbbbec33amea
纛: bbdb2zabadzbbbbmeae33amea
纠: 33fjd
纡: 33fbbm
红: 33fbdb
纣: 33fbma
纤: 33febd
纥: 33febw
约: 33feua
级: 33fe6c
纨: 33fewa
纩: 33fabe
纪: 33fzbn
纫: 33fuea
纬: 33fbbud
纭: 33fbb3a
纯: 33fb2dn
纰: 33fbjen
纱: 33fdeae
纲: 33fduea
纳: 33fduea
纴: 33febdb
纵: 33feaec
纶: 33fecen
纷: 33fecue
纸: 33fejbo
纹: 33fabec
纺: 33fabue
纻: 33faahb
纽: 33fzdbb
纾: 33fhahm
线: 33fbboea
绀: 33fbddbb
绁: 33fbddb2
绂: 33fbehca
练: 33fb3uea
组: 33fdzbbb
绅: 33fdzbbd
细: 33fdzbdb
织: 33fdzbea
终: 33fehcaa
绉: 33fehzbb
绊: 33faebbd
绋: 33fzbxed
绌: 33f2dd2d
绍: 33fuedzb
绎: 33fhcbbd
经: 33fhabdb
绑: 33fbbberd
绒: 33fbbeoea
结: 33fbdbdzb
绔: 33fbecbbx
绕: 33fboeben
绗: 33feedbbm
绘: 33fecbb3a
给: 33fecbdzb
绚: 33feudzbb
绛: 33fehcb3d
络: 33fehcdzb
绝: 33fehzdbn
绞: 33fabeaec
统: 33fab3aen
绠: 33fbdzbbec
绡: 33fdaedubb
绢: 33fdzbdubb
绣: 33febdecre
绤: 33feaecdzb
绥: 33feaaeieb
绦: 33fehcbmea
继: 33faebdea2
绨: 33faezbxde
绩: 33fbbdbdzea
绪: 33fbdbedzbb
绫: 33fbdbeaehc
续: 33fbdhaabea
绮: 33fbeabdzbm
绯: 33fdbbbdbbb
绰: 33fdbdzbbbd
绲: 33fdzbbbjen
绳: 33fdzbdzbbn
维: 33fedabbbdb
绵: 33fedzbbdud
绶: 33feaaeahhc
绷: 33feubbeubb
绸: 33feubdbdzb
绹: 33feuebbd2d
绺: 33fehcdadzb
绻: 33faebbecun
综: 33faahbbmea
绽: 33faahbdbec
绾: 33faahdzbzb
绿: 33fzbbmafec
缀: 33fhahahahc
缁: 33fiiidzbdb
缂: 33fbddbdzbbd
缃: 33fbdeadzbbb
缄: 33fbebdzboea
缅: 33fbedzddbbb
缆: 33fddebadzen
缇: 33fdzbbbdbec
缈: 33fdzbbbdeae
缉: 33fdzbbddbbb
缌: 33fdzbdbaoaa
缎: 33fedbbfeqhc
缏: 33fedbdzbbec
缑: 33fedzbebbec
缒: 33fedzbzba6c
缓: 33feaaebbehc
缔: 33fabaeahdud
缕: 33faebdecieb
编: 33fazbedubdd
缗: 33fzbjbodzbb
缘: 33f3hbeleeec
缙: 33fbddaebdzbb
缚: 33fbdzbbdabma
缛: 33fbebbjecbma
缜: 33fbddzbbbbea
缝: 33fehcbbbda6c
缟: 33fabdzbdudzb
缠: 33fabedzbbdbb
缡: 33fabea2ddu3a
缢: 33faebeadzddb
缣: 33faebzbbddec
缤: 33faahedbdbea
缥: 33fbdzddbbbmea
缦: 33fdzbbdzddbhc
缧: 33fdzbdb33amea
缨: 33fdzeadzeaieb
缩: 33faahedbedzbb
缪: 33fzafzafeceee
缫: 33fiiidzbbbdec
缬: 33fbdbdzbbedzea
缭: 33fbecaedzbbmea
缮: 33faebbbdaebdzb
缯: 33faedzdaebdzbb
缰: 33fbdzbdbbdzbdbb
缱: 33fdzbdbdzbzba6c
缲: 33fdzbdzbdzbbdec
缳: 33fdzddbbdzbejec
缴: 33fedzbbabueebec
缵: 33febdbejebdbendzea
缶: ebbd2d
缸: ebbd2dbdb
缺: ebbd2dzbec
罂: dzeadzeaebbd2d
罄: bdbzdbeeqhaebbd2d
罅: ebbd2ddbhebneaebm
罐: ebbd2dbdddzbdzbedabbbdb
网: dueaea
罔: duaebab2
罕: aheabbd
罗: dzddbeha
罘: dzddbbeda
罚: dzddbakdm
罟: dzddbbddzb
罡: dzddbbdbdb
罢: dzddbbdb3a
罨: dzddbbecdzbbn
罩: dzddbdbdzbbbd
罪: dzddbdbbbdbbb
置: dzddbbddzbbbb
罱: dzddbbdduaebbd
署: dzddbbdbedzbb
罴: dzddbbdb3aaaaa
罹: dzddbaadedabbbdb
罽: dzddbbeaeeaaeeadm
罾: dzddbaedzdaebdzbb
羁: dzddbbddbdzbbdzxb
羊: aebbbd
羌: aebbben
美: aebbdbbec
羑: aebbdbehc
羔: aebbdbaaaa
羚: aebbbeecaha
羝: aebbbeejboa
羞: aebbbezdbb
羟: aebbbehabdb
羡: aebbdbafehec
群: zbbedzbaebbbd
羧: aebbbe3aeaehc
羯: aebbbedzbbeuea2
羰: aebbbed2dbeaeec
羲: aebbdbebdeabxoea
羸: ab2dzbeubbaebbbdewa
羹: aebbdbaaaaaebbdbbec
羼: zbeaebbbdaebbbeaebbbd
羽: uafuaf
羿: zafzafbed
翁: ec3auafuaf
翅: bdhcuafuaf
翊: abaefuafuaf
翌: zafzafabaeb
翎: eaahauafuaf
翔: aebbbeuafuaf
翕: ecbdzbuafuaf
翘: boebenuafuaf
翙: d2dehauafuaf
翚: zafzafahb3bd
翟: zafzafedabbbdb
翠: zafzafabeaeabd
翡: dbbbdbbbuafuaf
翥: bdbedzbbuafuaf
翦: aebdubbdmuafuaf
翩: azbedubdduafuaf
翮: bdzbduaebduafuaf
翯: zafzafabdzbdudzb
翰: bddzbbbdecuafuaf
翱: edzbbbeabduafuaf
翳: bebbea2eqhcuafuaf
翻: eaebdeadzbdbuafuaf
翼: zafzafdzbdbbddbea
耀: daebejzafzafedabbbdb
老: bdbeen
考: bdbebx
耄: bdbeenebbn
者: bdbedzbb
耆: bdbeendzbb
耋: bdbeenb3abdb
而: bedudd
耍: beduddieb
耐: beduddbma
耒: bbbdec
耔: bbbdeahmb
耕: bbbdeabbed
耖: bbbdeadeae
耗: bbbdeaebbn
耘: bbbdeabb3a
耙: bbbdeazdbn
耜: bbbdeadzbzb
耠: bbbdeaecbdzb
耢: bbbdeabddahue
耥: bbbdeadaedudzb
耦: bbbdeadzbbdudfa
耧: bbbdeaaebdecieb
耨: bbbdeabebbjecbma
耩: bbbdeabbddbdudbb
耪: bbbdeaabaeahabue
耰: bbbdeabedzbbahaoaaehc
耱: bbbdeaabebdeabdecbedzb
耲: bbbdeaabdzddbdafeaejec
耳: bddbbb
耵: bddbbfbm
耶: bddbbfrd
耷: becbddbbb
耸: eaecbddbbb
耻: bddbbfdbdb
耽: bddbbfahen
耿: bddbbfaeec
聂: bddbbbhahc
聃: bddbbfdudbb
聆: bddbbfecaha
聊: bddbbfejeud
聋: beneabddbbb
职: bddbbfdzbea
聍: bddbbfaahbm
聒: bddbbfebddzb
联: bddbbfaebbec
聘: bddbbfdzbdbbx
聚: bddbbfhaedeeec
聩: bddbbfdzbdbdzea
聪: bddbbfaedzbaoaa
聱: bbdbueebecbddbbb
聿: zbbbbd
肃: zbbdedea
肄: enebbeazbbbbd
肆: bdbbb3azbbbbd
肇: azbeebeczbbbbd
肉: dueaea
肋: eubbue
肌: eubbew
肓: ab2dubb
肖: daedubb
肘: eubbbma
肚: eubbbdb
肛: eubbbdb
肝: eubbbbd
肟: eubbbbx
肠: eubbree
股: eubbeqhc
肢: eubbbdhc
肤: eubbbbec
肥: eubbzdbn
肩: azbedubb
肪: eubbabue
肫: eubbb2dn
肭: eubbduea
肮: eubbabew
肯: dbdbdubb
肱: eubbbe3a
育: ab3adubb
肴: eabedubb
肷: eubbehec
肺: eubbbdud
肼: eubbbbed
肽: eubbbeca
肾: ddhcdubb
肿: eubbdzbd
胀: eubbebjc
胁: eubbueaa
胂: eubbdzbbd
胃: dzbdbdubb
胄: dzbdbdubb
胆: eubbdzbbb
背: dbfendubb
胍: eubbeejac
胎: eubb3adzb
胖: eubbaebbd
胗: eubbeceee
胙: eubbebdbb
胚: eubbbedab
胛: eubbdzbbd
胜: eubbebbdb
胝: eubbejboa
胞: eubbeuzbn
胡: bddzbeubb
胤: e33adubbn
胥: hdbecdubb
胧: eubbbenea
胨: eubbb3mea
胩: eubbdbbda
胪: eubbdbzbe
胫: eubbhabdb
胬: iebhcdueaea
胭: eubbdzbeab
胯: eubbbecbbx
胰: eubbbzbxec
胱: eubbdaeben
胲: eubbab3eea
胳: eubbehcdzb
胴: eubbdubdzb
胶: eubbabeaec
胸: eubbeuea2d
胺: eubbaahieb
胼: eubbaebbed
能: 3adubbenen
脂: eubbendzbb
脆: eubbehbeun
脉: eubbauhec
脊: afeaecdubb
脍: eubbecbb3a
脎: eubbeabmea
脏: eubbabebdb
脐: eubbabeced
脑: eubbabea2d
脒: eubbaebdec
脓: eubbahejec
脔: abddeadueaea
脖: eubbbdahhmb
脘: eubbaahbben
脚: eubbbdb3aud
脞: eubbeaeabdb
脬: eubbeaaehmb
脯: eubbbdubbda
脱: eubbaedzben
脲: eubbzbemhec
脶: eubbdzbduea
脸: eubbecbaaeb
脾: eubbedzbbebd
腆: eubbdzbddbea
腈: eubbbbdbdubb
腊: eubbbddbdzbb
腋: eubbabedehac
腌: eubbbecdzbbn
腐: abeedbmadueaea
腑: eubbabeedbma
腒: eubbzbebddzb
腓: eubbdbbbdbbb
腔: eubbaaheabdb
腕: eubbaahehaun
腙: eubbaahbbmea
腚: eubbaahbdbec
腠: eubbbbbecbbea
腥: eubbdzbbebbdb
腧: eubbecbdubbdm
腩: eubbbdduaebbd
腭: eubbdzbdzbbbx
腮: eubbdzbdbaoaa
腰: eubbbdzddbieb
腱: eubbzbbbbd6c
腴: eubbedbzbbec
腹: eubbebdzbbehc
腺: eubbedzbbmhec
腻: eubbbbbdzeaoa
腼: eubbbedzddbbb
腽: eubbdzbbdzddb
腾: eubbaebbeczxb
腿: eubbzbbjeaa6c
膀: eubbabaeahabue
膂: abueebejecdubb
膈: eubbbdzbduaebd
膊: eubbbdzbbdabma
膏: abdzbahdzbdubb
膑: eubbaahedbdbea
膘: eubbbdzddbbbmea
膙: eubbzbxdzbdzbdba
膛: eubbdaeahdzbbdb
膜: eubbbdddzbbbec
膝: eubbbdeaecmafaa
膦: eubbaebdecehab3d
膨: eubbbdbdzbaefeee
膪: eubbabaeahduddzb
膳: eubbaebbbdaebdzb
膺: abeededabbbdbdubb
膻: eubbabdzdzbbdzbbb
臀: zbebddbeaeqhcdubb
臁: eubbabeaebzbbddec
臂: zbedzbabaebbddubb
臃: eubbab33eedabbbdb
臆: eubbabaebdzbbaoaa
臊: eubbdzbdzbdzbbdec
臌: eubbbdbdzbaefbdhc
臑: eubbbahdaaaabedudd
臜: eubbebdbejebdbendzea
臣: bdzbd2
臧: be2bebdzbd2oea
自: edzbbb
臬: edzbbbbdec
臭: edzbbbbeca
至: b3abdb
致: b3abdfebec
臻: b3abdfbbbecebdea
臼: edbzbb
臾: edbzbbec
舀: eaaeedbzbb
舂: bbbecedbzbb
舄: edbzbbeuaaaa
舅: edbzbbdzbdbue
舆: edbbb3bdzbbbea
舌: ebddzb
舍: ecbbddzb
舐: ebddzbejbo
舒: eabbddzbhahm
舔: ebddzbbbecmaaa
舛: ehab3d
舜: eaaeahehab3d
舞: ebbddddbehab3d
舟: eeuaba
舢: eeuabad2d
舣: eeuabaaec
舨: eeuabaeehc
航: eeuabaabew
舫: eeuabaabue
般: eeuabaeqhc
舰: eeuabadzen
舱: eeuabaecun
舳: eeuabadzbdb
舴: eeuabaebdbb
舵: eeuabaaahen
舶: eeuabaedzbb
舷: eeuabaab33a
舸: eeuababdzbm
船: eeuabaeqdzb
舻: eeuabadbzbe
舾: eeuababdze2b
艄: eeuabadaedubb
艇: eeuabaebdb6c
艋: eeuabahmbdzddb
艘: eeuabaedbzbbdhc
艚: eeuababdzbddbdzbb
艟: eeuabaabaebdzbbdbb
艨: eeuababddahbbeleeec
艮: zbbjec
良: azbbjec
艰: hazbbjec
色: ehzdbn
艳: bbbdehzdbn
艴: zbxedehzdbn
艺: bddw
艽: bddew
艾: bddec
艿: bdd7e
节: bddud
芄: bddewa
芈: dbdbbbd
芊: bddebd
芋: bddbbm
芍: bddeua
芎: bddzbx
芏: bddbdb
芑: bddzbn
芒: bddab2
芗: bdd33e
芙: bddbbec
芜: bddbben
芝: bddahc
芟: bddeqhc
芡: bddehec
芥: bddeced
芦: bddazbe
芨: bdde6c
芩: bddecah
芪: bddejbo
芫: bddbben
芬: bddecue
芭: bddzdbn
芮: bddduea
芯: bddaoaa
芰: bddbdhc
花: bddeden
芳: bddabue
芴: bddeuee
芷: bdddbdb
芸: bddbb3a
芹: bddeebd
芼: bddebbn
芽: bddb3me
芾: bddbdud
苁: bddeaec
苄: bddabda
苇: bddbbud
苈: bddbeue
苊: bddbeun
苋: bdddzen
苌: bddebjc
苍: bddecun
苎: bddaahb
苏: bddueaa
苑: bddehaun
苒: bdddudbb
苓: bddecaha
苔: bdd3adzb
苕: bdduedzb
苗: bdddzbdb
苘: bdddudzb
苛: bddbdzbm
苜: bdddzbbb
苞: bddeuzbn
苟: bddeudzb
苠: bddzbjbo
苡: bddjaea
苣: bddbzb2
苤: bddbedab
若: bddbedzb
苦: bddbddzb
苫: bdddbdzb
苯: bddbdecb
英: bdddzbec
苴: bdddzbbb
苷: bddbddbb
苹: bddbaebd
苻: bddedbma
茀: bddzbxed
茁: bdd2dd2d
茂: bddbeoea
范: bddaafun
茄: bdduedzb
茅: bddhahme
茆: bddejeud
茈: bdddbdfen
茉: bddbbdec
茌: bddedbdb
茎: bddhabdb
茏: bddbenea
茑: bddeuaxb
茓: bddaahec
茔: bddahbdb
茕: bddahwbd
茗: bddehadzb
茚: bddejbud
茛: bddzbbjec
茜: bddbdze2b
茝: bddbddzbd2
茧: bdddzbdba
茨: bddafehec
茫: bddaafab2
茬: bddbedbdb
茭: bddabeaec
茯: bddedbeca
茱: bddebbdec
茳: bddaafbdb
茴: bdddzdzbb
茵: bdddzbeab
茶: bddecbmea
茸: bddbddbbb
茹: bddiebdzb
茼: bdddubdzb
荀: bddeudzbb
荃: bddecbbdb
荆: bddbbeddm
荇: bddeedbbm
草: bdddzbbbd
荏: bddedebdb
荐: bddbedhmb
荑: bddbzbxec
荒: bddab2edn
荔: bddueueue
荙: bddbeaa6c
荚: bddbaebec
荛: bddboeben
荜: bddbjenbd
荞: bddebeced
荟: bddecbb3a
荠: bddabeced
荡: bddaafree
荣: bddahbdec
荤: bddahb3bd
荥: bddahmhec
荦: bddahebbd
荧: bddahaeec
荨: bddzbbbma
荩: bddzbecaa
荪: bddhmfmea
荫: bddrdeubb
荬: bddhaabea
荭: bdd33fbdb
药: bdd33feua
荷: bddedbdzbm
荸: bddbdahhmb
荻: bddeleaeec
荼: bddecbbmea
荽: bddeaaeieb
莅: bddedabaeb
莆: bddbdubbda
莉: bddebdeadm
莎: bddaafdeae
莒: bdddzbdzb
莓: bddeb2uaba
莘: bddabaebbd
莙: bddzbbedzb
莛: bddebdb6c
莜: bddeddebec
莞: bddaahbben
莠: bddebdecre
莨: bddazbbjec
莩: bddeaaehmb
莪: bddebmfoea
莫: bdddzbbbec
莰: bddbdfehec
莱: bddbaebdec
莲: bddb3bda6c
莳: bdddzbbbma
莴: bdddzbduea
莶: bddecbaaeb
获: bddelebeca
莸: bddelebena
莹: bddahbbdba
莺: bddaheuaxb
莼: bdd33fb2dn
莽: bddbecabed
菀: bddaahehaun
菁: bddbbdbdubb
菂: bddedzbbeua
菅: bddaahdzbzb
菇: bddiebbddzb
菊: bddeuaebdea
菌: bdddzebdeab
菏: bddaafbdzbm
菔: bddeubbudhc
菖: bdddzbbdzbb
菘: bddbdeaec3a
菜: bddeaaebdec
菝: bddbmfbehca
菟: bddehdzbena
菠: bddaafhedhc
菡: bddhmafea2d
菥: bddbdeaeebd
菩: bddabaebdzb
菪: bddaahbedzb
菰: bddhmfeejac
菱: bddbdbeaehc
菲: bdddbbbdbbb
菹: bddaafdzbbb
菼: bddaeeaaeec
菽: bdddbbmeahc
萁: bddbddbbbea
萃: bddabeaeabd
萄: bddeuebbd2d
萋: bddbzbbdieb
萌: bdddzbbeubb
萍: bddaafbaebd
萎: bddebdecieb
萏: bddehedbzbb
萑: bddedabbbdb
萘: bddbecbbmea
萜: bddduddbdzb
萝: bdddzddbeha
萤: bddahdzbdba
营: bddahdzbdzb
萦: bddah33amea
萧: bddzbbdedea
萨: bddrdabaebe
萩: bddebdeaaeec
萱: bddaahbdzbbb
萸: bddedbzbbec
萼: bdddzbdzbbbx
落: bddaafehcdzb
葆: bddeddzbbdec
葑: bddbdbbdfbma
葓: bddaafbddbea
葖: bddaaheabeca
著: bddbdbedzbb
葚: bddbddbbbea2
葛: bdddzbbeuea2
葜: bddbbbduebec
葡: bddeubdubbda
董: bddebdzbbdbb
葩: bddedzbbzdbn
葫: bddbddzbeubb
葬: bddbehaenbed
葭: bddzbdbbzbhc
葱: bddeueeaaoaa
葳: bddbebieboea
葵: bddhaeecbbea
葶: bddabdzbahbm
葸: bdddzbdbaoaa
葺: bdddzbbddbbb
蒂: bddabaeahdud
蒇: bddbedzeaoea
蒈: bddbjenedzbb
蒉: bdddzbdbdzea
蒋: bddafdehabma
蒌: bddaebdecieb
蒎: bddaafeeejec
蒗: bddaafazbbjec
蒙: bddahbbeleeec
蒜: bddbbmeabbmea
蒟: bddabaefeudzb
蒡: bddabaeahabue
蒯: bddeubbeubbdm
蒲: bddaafbdubbda
蒴: bddaeb2deeubb
蒸: bddhmhecbaaaa
蒹: bddaebzbbddec
蒺: bddabeafebbec
蒽: bdddzbeabaoaa
蒿: bddabdzbdudzb
蓁: bddbbbecebdea
蓂: bddahdzbbabea
蓄: bddab33adzbdb
蓇: bdddzzahdubb
蓉: bddaaheaecdzb
蓊: bddec3auafuaf
蓍: bddbdbeendzbb
蓐: bddbebbjecbma
蓑: bddabdzbbejec
蓓: bddedabaebdzb
蓖: bddedzeabbjen
蓝: bddddebadzddb
蓟: bddehdzbdbfdm
蓠: bddabea2ddu3a
蓣: bddhahmbedzea
蓥: bddahecbbdaeb
蓦: bdddzbbbeczxb
蓬: bddehcbbbda6c
蓰: bddeeddbdbdbec
蓼: bddzafzafeceee
蓿: bddaahedbedzbb
蔌: bddbdzbdeaehec
蔑: bdddzddbbeaoea
蔓: bdddzbbdzddbhc
蔗: bddabebddbaaaa
蔚: bddzbebbmeabma
蔟: bddabueebebbec
蔡: bddehaahcbbmea
蔫: bddbdbdbbxaaaa
蔬: bddhdbdfab3aedn
蔷: bddbdaebdzdzbb
蔸: bddedzbbejzben
蔹: bddecbaaefebec
蔺: bddaduedabbbdb
蔻: bddaahbbendbha
蔼: bddakdzbbeuea2
蔽: bddaedudeaebec
蕃: bddeaebdecdzbdb
蕈: bddbdzddbdzbbbd
蕉: bddedabbbdbaaaa
蕊: bddaoaaaoaaaoaa
蕖: bddaafbzb2bdec
蕙: bddbdzbbdbaaoaa
蕞: bdddzbbbddbbfhc
蕤: bddbeleeecebbdb
蕨: bddbeaeb2deehec
蕰: bddaafdzbbdzddb
蕲: bddaedzbbbdeebd
蕴: bdd33fdzbbdzddb
蕹: bddab33eedabbbdb
蕺: bdddzbbddbbfoea
蕻: bddbdbbb3abddbea
蕾: bddbahdaaaadzbdb
薄: bddaafbdzbbdabma
薅: bddiebbebbjecbma
薇: bddeedd2dbekebec
薏: bddabaebdzbbaoaa
薛: bddedzbzbabaebbd
薜: bddzbedzbabaebbd
薤: bddbehadbbbdbbbb
薨: bdddzddbahbehaen
薪: bddabaebbmeaeebd
薮: bddaebdeaiebebec
薯: bdddzddbbdbedzbb
薰: bddebdzaebdbbaaaa
薷: bddbahdaaaabedudd
薹: bddbdbdzbahb3abdb
藁: bddabdzbdudzbbdec
藉: bddbbbdeabddbdzbb
藏: bddbe2bebdzbd2oea
藐: bddeaaeleeedzbben
藓: bddehdzbdbfaebbbd
藕: bddbbbdeadzbbdudfa
藜: bddebdeaeueecmafea
藠: bddedzbbedzbbedzbb
藤: bddeubbaebbecmafea
藩: bddaafeaebdecdzbdb
藻: bddaafdzbdzbdzbbdec
藿: bddbahdaaaaedabbbdb
蘅: bddeedehdzbdbbeabbm
蘑: bddabebdeabdecbedzb
蘖: bddedzbzbabaebbdbdec
蘘: bddabdzbdzbbbddbejec
蘧: bdddbhebnbeleeeaa6c
蘩: bddeb2zabaebec33amea
蘸: bddbdze2bbedabbbdbaaaa
蘼: bddabebdeabdecdbbbdbbb
虎: dbhebnew
虏: dbhebnue
虐: dbhebnb2b
虑: dbhebnaoaa
虔: dbhebnabec
虚: dbhebnddaeb
虞: dbhebndzbbbec
虢: eaaebmadbhebnew
虫: dzbdba
虬: dzbdban
虮: dzbdbaew
虱: wedzbdba
虹: dzbdbabdb
虺: bendzbdba
虻: dzbdbaab2
虼: dzbdbaebw
虽: dzbdzbdba
虾: dzbdbabda
虿: buedzbdba
蚀: ehjdzbdba
蚁: dzbdbaaec
蚂: dzbdbazxb
蚊: dzbdbaabec
蚋: dzbdbaduea
蚌: dzbdbabbbd
蚍: dzbdbabjen
蚓: dzbdbazbxd
蚕: bbecdzbdba
蚜: dzbdbab3me
蚝: dzbdbaebbn
蚣: dzbdbaec3a
蚤: hcadzbdba
蚧: dzbdbaeced
蚨: dzbdbabbec
蚩: 2ddbdzbdba
蚪: dzbdbaaabd
蚬: dzbdbadzen
蚯: dzbdbaedbdb
蚰: dzbdbadzbdb
蚱: dzbdbaebdbb
蚴: dzbdba33aue
蚶: dzbdbabddbb
蚺: dzbdbadudbb
蛀: dzbdbaabbdb
蛄: dzbdbabddzb
蛆: dzbdbadzbbb
蛇: dzbdbaaahen
蛉: dzbdbaecaha
蛊: dzbdbadzddb
蛋: hdbecdzbdba
蛎: dzbdbabebue
蛏: dzbdbahcbdb
蛐: dzbdbadzbddb
蛑: dzbdba3aebbd
蛔: dzbdbadzdzbb
蛘: dzbdbaaebbbd
蛙: dzbdbabdbbdb
蛛: dzbdbaebbdec
蛞: dzbdbaebddzb
蛟: dzbdbaabeaec
蛤: dzbdbaecbdzb
蛩: bdfewadzbdba
蛭: dzbdbab3abdb
蛮: abddeadzbdba
蛰: bmfewadzbdba
蛱: dzbdbabaebec
蛲: dzbdbaboeben
蛳: dzbdbadebdud
蛴: dzbdbaabeced
蛸: dzbdbadaedubb
蛹: dzbdbahadubbd
蛾: dzbdbaebmfoea
蜀: dzddbeudzbdba
蜂: dzbdbaehcbbbd
蜃: bebbjecdzbdba
蜇: bmfeebddzbdba
蜈: dzbdbadzbbbec
蜉: dzbdbaeaaehmb
蜊: dzbdbaebdeadm
蜍: dzbdbaecbbmea
蜎: dzbdbadzbdubb
蜒: dzbdbaedb26c
蜓: dzbdbaebdb6c
蜕: dzbdbaaedzben
蜗: dzbdbadzbduea
蜘: dzbdbaebbeadzb
蜚: dbbbdbbbdzbdba
蜜: aahaoaeadzbdba
蜞: dzbdbabddbbbea
蜡: dzbdbabddbdzbb
蜢: dzbdbahmbdzddb
蜣: dzbdbaaebbben
蜥: dzbdbabdeaeebd
蜩: dzbdbaeubdbdzb
蜮: dzbdbabdzbfoea
蜱: dzbdbaedzbbebd
蜴: dzbdbadzbbeuee
蜷: dzbdbaaebbecun
蜻: dzbdbabbdbdubb
蜾: dzbdbadzbbbdec
蜿: dzbdbaaahehaun
蝇: dzbdbadzbdzbbn
蝈: dzbdbadzbbdbab
蝉: dzbdbaaedzbbbd
蝌: dzbdbaebdeaaabd
蝎: dzbdbadzbbeuea2
蝓: dzbdbaecbdubbdm
蝗: dzbdbaedzbbbbdb
蝙: dzbdbaazbedubdd
蝠: dzbdbabdzbdzbdb
蝣: dzbdbaabueebhmb
蝤: dzbdbaaebdze2bb
蝥: hahmeebecdzbdba
蝮: dzbdbaebdzbbehc
蝰: dzbdbabecbdbbdb
蝴: dzbdbabddzbeubb
蝶: dzbdbabddb2bdec
蝻: dzbdbabdduaebbd
蝼: dzbdbaaebdecieb
蝽: dzbdbabbbecdzbb
蝾: dzbdbabddahbdec
螂: dzbdbaazbbjard
螃: dzbdbaabaeahabue
螅: dzbdbaedzbbbaoaa
螈: dzbdbabeedzbbmea
螋: dzbdbaedbzbbdhc
融: bdzbduaebddzbdba
螗: dzbdbaabezbbddzb
螟: dzbdbaahdzbbabea
螠: dzbdbaaebeadzddb
螣: eubbaebbecdzbdba
螨: dzbdbabddbdueaea
螫: bdbemeaebecdzbdba
螬: dzbdbabdzbddbdzbb
螭: dzbdbaabea2ddu3a
螯: bbdbueebecdzbdba
螳: dzbdbadaeahdzbbdb
螵: dzbdbabdzddbbbmea
螺: dzbdbadzbdb33amea
螽: ehcaadzbdbadzbdba
蟀: dzbdbaab33aafeabd
蟆: dzbdbabdddzbbbec
蟊: hahmedzbdbadzbdba
蟋: dzbdbaeaebdecaoaa
蟑: dzbdbaabaebdzbbbd
蟒: dzbdbabddbecabed
蟛: dzbdbabdbdzbaefeee
蟠: dzbdbaeaebdecdzbdb
蟥: dzbdbabddbdzbdbea
蟪: dzbdbabdzbbdbaaoaa
蟮: dzbdbaaebbbdaebdzb
蟹: eheubbdueebbddzbdba
蟾: dzbdbaehbeeaabbbdzb
蠃: ab2dzbeubbdzbdbaewa
蠊: dzbdbaabeaebzbbddec
蠋: dzbdbadzddbeudzbdba
蠓: dzbdbabddahbbeleeec
蠕: dzbdbabahdaaaabedudd
蠖: dzbdbabddedabbbdbhc
蠡: 3hbeleeecdzbdbadzbdba
蠢: bbbecdzbbdzbdbadzbdba
蠲: aebeadzddfdzddbeudzbdba
蠹: bdzbdahbedzbdzbdbadzbdba
蠼: dzbdbadzbbbdzbbbedabbbdbhc
血: edzddb
衄: edzddfzdbb
衅: edzddfaebbd
行: eedbbm
衍: eedaafbbm
衔: eedebbbjbbm
街: eedbdbbdfbbm
衙: eedbdzbdzbbbm
衡: eedehdzbdbbeabbm
衢: eeddzbbbdzbbbedabbbdbbbm
衣: abejec
补: ahdeada
表: bbdbejec
衩: ahdeahca
衫: ahdeaeee
衬: ahdeabma
衮: abea3aejec
衰: abdzbbejec
衲: ahdeaduea
衷: abdzbdejec
衽: ahdeaebdb
衾: ecahabejec
衿: ahdeaecah
袁: bdbdzbejec
袂: ahdeazbec
袄: ahdeaebec
袅: euaxabejec
袆: ahdeabbud
袈: uedzbabejec
袋: edboaabejec
袍: ahdeaeuzbn
袒: ahdeadzbbb
袖: ahdeadzbdb
袗: ahdeaeceee
袜: ahdeabbdec
袢: ahdeaaebbd
袤: abhahmeejec
袪: ahdeabdb3a
被: ahdeahedhc
袭: beneaabejec
袯: ahdea2ehca
袱: ahdeaedbeca
袼: ahdeaehcdzb
裁: bdbabejeaoea
裂: behadmabejec
装: afdbdbabejec
裆: ahdeadaezbb
裈: ahdeaahb3bd
裉: ahdeazbbjec
裎: ahdeadzbbbdb
裒: abedbzbbejec
裔: abejecdueadzb
裕: ahdeaeaecdzb
裘: bdafeaaabejec
裙: ahdeazbbedzb
裟: aafdeaeabejec
裢: ahdeab3bda6c
裣: ahdeaecbaaeb
裤: ahdeaabeb3bd
裥: ahdeaadudzbb
裨: ahdeaedzbbebd
裰: ahdeahahahahc
裱: ahdeabbdbejec
裳: daeahdzbabejec
裴: dbbbdbbbabejec
裸: ahdeadzbbbdec
裹: abdzbbbdeaejec
裼: ahdeadzbbeuee
裾: ahdeazbebddzb
褂: ahdeabdbbdfda
褊: ahdeaazbedubdd
褐: ahdeadzbbeuea2
褒: abeddzbbdeaejec
褓: ahdeaeddzbbdec
褙: ahdeadbfendubb
褚: ahdeabdbedzbb
褛: ahdeaaebdecieb
褡: ahdeabddecbdzb
褥: ahdeabebbjecbma
褪: ahdeazbbjeaa6c
褫: ahdeaeedbhebnew
褰: aahbbddbecabejec
褴: ahdeaddebadzddb
褶: ahdeazafzafedzbb
襁: ahdeazbxdzbdzbdba
襄: abdzbdzbbbddbejec
襕: ahdeaadubdzaebdec
襞: zbedzbabaebbdabejec
襟: ahdeabdeabdecbbmea
襦: ahdeabahdaaaabedudd
襻: ahdeabdeaeaeabdeabecebbm
西: bdze2b
要: bdzddbieb
覃: bdzddbdzbbbd
覆: bdzddbeedebdzbbehc
见: dzen
观: hadzen
规: bbeadzen
觅: eaaedzen
视: ahdadzen
觇: dbdzbdzen
览: ddebadzen
觉: aaeahdzen
觊: d2dzbjdzen
觋: bdeaeafdzen
觌: bdhaabeadzen
觎: eabdubbdmdzen
觏: bbddbdudbbdzen
觐: bddbdzbbbdfdzen
觑: dbhebnddaefdzen
角: eheubbd
觖: eheubbdzbec
觚: eheubbdeejac
觜: dbdfeneheubbd
觞: eheubbdebree
解: eheubbdueebbd
觥: eheubbddaeben
触: eheubbddzbdba
觫: eheubbdbdzbdec
觯: eheubbdaedzbbbd
觱: bebdzboeaeheubbd
觳: bdbahbeheubbdeqhc
言: abbbdzb
訄: ewabbbdzb
訇: euabbbdzb
訾: dbdfenabbbdzb
詈: dzddbabbbdzb
詹: ehbeeaabbbdzb
誉: aaebecabbbdzb
誊: aebbecabbbdzb
誓: bmfeebdabbbdzb
謇: aahbbddbecabbbdzb
警: bddeudzbebecabbbdzb
譬: zbedzbabaebbdabbbdzb
计: akbd
订: akbm
讣: akda
认: akec
讥: akew
讦: akbbd
讧: akbdb
讨: akbma
让: akdbb
讪: akd2d
讫: akebw
训: akedd
议: akaec
讯: akwbd
记: akzbn
讲: akbbed
讳: akbbud
讴: akbea2
讵: akbzb2
讶: akb3me
讷: akduea
许: akebbd
讹: akeden
论: akecen
讼: akec3a
讽: akewea
设: akeqhc
访: akabue
诀: akzbec
证: akbdbdb
诂: akbddzb
诃: akbdzbm
评: akbaebd
诅: akdzbbb
识: akdzbea
诈: akebdbb
诉: akeebda
诊: akeceee
诋: akejboa
诌: akehzbb
词: akubdzb
诎: ak2dd2d
诏: akuedzb
诐: akhedhc
译: akhcbbd
诒: ak3adzb
诓: akbbbdb2
诔: akbbbdec
试: akbbdfoa
诖: akbdbbdb
诗: akbdbbma
诘: akbdbdzb
诙: akbeaeec
诚: akbeuoea
诛: akebbdec
诜: akebdben
话: akebddzb
诞: akedb26c
诟: akeebdzb
诠: akecbbdb
诡: akehbeun
询: akeudzbb
诣: akendzbb
诤: akehzbbm
该: akab3eea
详: akaebbbd
诧: akaahebn
诨: akahb3bd
诩: akuafuaf
诫: akbbedoea
诬: akbdeaeab
语: akbdzbdzb
诮: akdaedubb
误: akdzbbbec
诰: akebdbdzb
诱: akebdecre
诲: akeb2uaba
诳: akelebbdb
说: akaedzben
诵: akhadubbd
请: akbbdbdubb
诸: akbdbedzbb
诹: akbddbbfhc
诺: akbddbedzb
读: akbdhaabea
诼: akbeleeaec
诽: akdbbbdbbb
课: akdzbbbdec
诿: akebdecieb
谀: akedbzbbec
谁: akedabbbdb
谂: akecahaoaa
调: akeubdbdzb
谄: akehedbzbb
谅: akabdzbmea
谆: akabdzbhmb
谇: akabeaeabd
谈: akaeeaaeec
谊: akaahdzbbb
谋: akbddbbbdec
谌: akbddbbbea2
谍: akbddb2bdec
谎: akbddab2edn
谏: akbdzaebdec
谐: akbjenedzbb
谑: akdbhebnb2b
谒: akdzbbeuea2
谓: akdzbdbdubb
谔: akdzbdzbbbx
谕: akecbdubbdm
谖: akeaaebbehc
谗: akehdzbenaa
谙: akabaebdzbb
谚: akabaebeeee
谛: akabaeahdud
谜: akaebdeaa6c
谝: akazbedubdd
谟: akbdddzbbbec
谠: akdaeahdzben
谡: akdzbdbeaehc
谢: akedubbbebma
谣: akeaaeebbd2d
谤: akabaeahabue
谥: akaebeadzddb
谦: akaebzbbddec
谧: akaoaeadzddb
谨: akbddbdzbbbdb
谩: akdzbbdzddbhc
谪: akabaedubddzb
谫: akaebdubbdmue
谬: akzafzafeceee
谭: akbdzddbdzbbbd
谮: akb3ejb3endzbb
谯: akedabbbdbaaaa
谰: akadubdzaebdea
谱: akaebddaebdzbb
谲: akhahmedueadzb
谳: akbdduaebbdbeca
谴: akdzbdbdzbzba6c
谵: akehbeeaabbbdzb
谶: akeaeabdbbbdbbbfoea
谷: eaecdzb
豁: aahbbbddzbeaecdzb
豆: bdzbaeb
豇: bdzbaefbdb
豉: bdzbaefbdhc
豌: bdzbaefaahehaun
豕: beleeec
豚: eubbbeleeec
象: ehdzbeleeec
豢: aebbecbeleeea
豨: beleeeaeabedud
豪: abdzbahbeleeec
豫: hahmehdzbeleeec
豳: dbeleeeabeleeea2d
豸: eaaelee
豹: eaaeleeeua
豺: eaaeleebme
貂: eaaeleeuedzb
貅: eaaeleeedbdec
貉: eaaeleeehcdzb
貊: eaaeleebedzbb
貌: eaaeleeedzbben
貔: eaaeleeedzeabbjen
貘: eaaeleebdddzbbbec
贝: dzea
贞: dbdzea
负: ehdzea
贡: bdbdzea
财: dzeabme
责: bbdbdzea
贤: ddhcdzea
败: dzeaebec
账: dzeaebjc
货: edendzea
质: eebddzea
贩: dzeaeehc
贪: ecahdzea
贫: ecuedzea
贬: dzeaeahc
购: dzeaeu3a
贮: dzeaaahb
贯: 2zdbdzea
贰: bbbdzeaoa
贱: dzeabboea
贲: bdbdddzea
贳: bddb2dzea
贴: dzeadbdzb
贵: dzbdbdzea
贶: dzeadzben
贷: edboadzea
贸: ejauedzea
费: zbxeddzea
贺: uedzbdzea
贻: dzea3adzb
贼: dzeabbeoea
贽: bmfewadzea
贾: bdzddbdzea
贿: dzeabedubb
赁: edebdbdzea
赂: dzeaehcdzb
赃: dzeaabebdb
资: afehecdzea
赅: dzeaab3eea
赆: dzeazbecaa
赇: dzeabmafeaa
赈: dzeabebbjec
赉: baebdecdzea
赊: dzeaecbbmea
赋: dzeabbdbdfoa
赌: dzeabdbedzbb
赍: bdeaeaahdzea
赎: dzeabdhaabea
赏: daeahdzbdzea
赐: dzeadzbbeuee
赑: dzeadzeadzea
赓: abezbbecdzea
赔: dzeaabaebdzb
赖: bdzbdeaehdzea
赘: bbdbueebecdzea
赙: dzeabdzbbdabma
赚: dzeaaebzbbddec
赛: aahbbddbecdzea
赜: bddzbd2bbdbdzea
赝: beededabbbdbdzea
赞: ebdbejebdbendzea
赟: abeabbdbdfoadzea
赠: dzeaaedzdaebdzbb
赡: dzeaehbeeaabbbdzb
赢: ab2dzbeubbdzeaewa
赣: abaebdzbbbdehcbdbdzea
赤: bdbemea
赦: bdbemeaebec
赧: bdbemeaudhc
赪: bdbemeadbdzea
赫: bdbemeabdbemea
赭: bdbemeabdbedzbb
走: bdbdbec
赳: bdbdbecjd
赴: bdbdbecda
赵: bdbdbecea
赶: bdbdbecbbd
起: bdbdbeczbn
趁: bdbdbececeee
趄: bdbdbecdzbbb
超: bdbdbecuedzb
越: bdbdbecbjoea
趋: bdbdbecehzbb
趑: bdbdbecafehea
趔: bdbdbecbehadm
趟: bdbdbecdaedudzb
趣: bdbdbecbddbbfha
趱: bdbdbecebdbejebdbendzea
足: dzbdbec
趴: dzbdbdfec
趵: dzbdbdfeua
趸: buedzbdbec
趺: dzbdbdfbbec
趼: dzbdbdfbbed
趾: dzbdbdfdbdb
趿: dzbdbdfe6c
跃: dzbdbdfebec
跄: dzbdbdfecun
跆: dzbdbdf3adzb
跋: dzbdbdfbehca
跌: dzbdbdfebbec
跎: dzbdbdfaahen
跏: dzbdbdfuedzb
跐: dzbdbdfdbdfen
跑: dzbdbdfeuzbn
跖: dzbdbdfbedzb
跗: dzbdbdfedbma
跚: dzbdbdfeueub
跛: dzbdbdfhedhc
距: dzbdbdfbzb2
跞: dzbdbdfe2mea
跟: dzbdbdfzbbjec
跣: dzbdbdfebdben
跤: dzbdbdfabeaec
跨: dzbdbdfbecbbx
跪: dzbdbdfehbeun
跬: dzbdbdfbdbbdb
路: dzbdbdfehcdzb
跳: dzbdbdfeafnea
践: dzbdbdfbboea
跶: dzbdbdfbeaa6c
跷: dzbdbdfboeben
跸: dzbdbdfbjenbd
跹: dzbdbdfebda6c
跺: dzbdbdfeqbdec
跻: dzbdbdfabeced
跽: dzbdbdfzbnaoaa
踅: bmfeebddzbdbec
踉: dzbdbdfazbbjec
踊: dzbdbdfhadubbd
踌: dzbdbdfbbbebma
踏: dzbdbdfmhecdzbb
踔: dzbdbdfdbdzbbbd
踝: dzbdbdfdzbbbdec
踞: dzbdbdfzbebddzb
踟: dzbdbdfebbeadzb
踢: dzbdbdfdzbbeuee
踣: dzbdbdfabaebdzb
踩: dzbdbdfeaaebdec
踪: dzbdbdfaahbbmea
踬: dzbdbdfeebddzea
踮: dzbdbdfabedbdzb
踯: dzbdbdfaebbeard
踱: dzbdbdfabebddbhc
踵: dzbdbdfebdzbbdbb
踶: dzbdbdfdzbbbdbec
踹: dzbdbdfd2dbedudd
踺: dzbdbdfzbbbbd6c
踽: dzbdbdfedzbdudfa
蹀: dzbdbdfbddb2bdec
蹁: dzbdbdfazbedubdd
蹂: dzbdbdfhahmebdec
蹄: dzbdbdfabaeahdud
蹅: dzbdbdfbdecdzbbb
蹇: aahbbddbecdzbdbec
蹈: dzbdbdfeaaeedbzbb
蹉: dzbdbdfaebbbebdb
蹊: dzbdbdfeaae33abec
蹋: dzbdbdfdzbbuafuaf
蹐: dzbdbdfafeaecdubb
蹑: dzbdbdfbddbbbhahc
蹒: dzbdbdfbddbdueaea
蹓: dzbdbdfejauedzbdb
蹙: bedbbmeaoeadzbdbec
蹜: dzbdbdfaahedbedzbb
蹢: dzbdbdfabaedubddzb
蹦: dzbdbdfd2deubbeubb
蹩: aedudeaebecdzbdbec
蹬: dzbdbdfhaeecbdzbaeb
蹭: dzbdbdfaedzdaebdzbb
蹯: dzbdbdfeaebdecdzbdb
蹰: dzbdbdfbebdzbaefbma
蹲: dzbdbdfaebdze2bbbma
蹴: dzbdbdfabdzbmeabena
蹶: dzbdbdfbeaeb2deehec
蹼: dzbdbdfddaebaebbbec
蹽: dzbdbdfbecaedzbbmea
蹾: dzbdbdfabdzbhmfebec
蹿: dzbdbdfaaheadzbdzbd
躁: dzbdbdfdzbdzbdzbbdec
躅: dzbdbdfdzddbeudzbdba
躇: dzbdbdfbddbdbedzbb
躏: dzbdbdfbddaduedabbbdb
躐: dzbdbdfiiidzeabjaajaao
躔: dzbdbdfabedzbbdbbeabdb
躜: dzbdbdfebdbejebdbendzea
躞: dzbdbdfabbbdzbaeeaaeeahc
身: edubbbe
躬: edubbbezbx
躯: edubbbebea2
躲: edubbbeeqbdec
躺: edubbbedaedudzb
车: b3bd
轧: b3dfn
轨: b3dfew
轩: b3dfbbd
轪: b3dfbec
轫: b3dfuea
转: b3dfbb5a
轭: b3dfbeun
轮: b3dfecen
软: b3dfehec
轰: b3bdhahc
轱: b3dfbddzb
轲: b3dfbdzbm
轳: b3dfdbzbe
轴: b3dfdzbdb
轵: b3dfdzbea
轶: b3dfebbec
轷: b3dfeaebm
轸: b3dfeceee
轹: b3dfe2mea
轺: b3dfuedzb
轻: b3dfhabdb
轼: b3dfbbdfoa
载: bdbb3dfoea
轾: b3dfb3abdb
轿: b3dfebeced
辀: b3dfeeuaba
辁: b3dfecbbdb
辂: b3dfehcdzb
较: b3dfabeaec
辄: b3dfbddbbfn
辅: b3dfbdubbda
辆: b3dfbdueaea
辇: bbeabbecb3bd
辈: dbbbdbbbb3bd
辉: daebejahb3bd
辊: b3dfdzbbbjen
辋: b3dfduaebab2
辌: b3dfabdzbmea
辍: b3dfhahahahc
辎: b3dfiiidzbdb
辏: b3dfbbbecbbea
辐: b3dfbdzbdzbdb
辑: b3dfdzbbddbbb
辒: b3dfdzbbdzddb
输: b3dfecbdubbdm
辔: 33fb3bd33fdzb
辕: b3dfbdbdzbejec
辖: b3dfaahbbbddzb
辗: b3dfzbebddbjec
辘: b3dfabezddbbjen
辙: b3dfab3adubbebec
辚: b3dfaebdecehab3d
辛: abaebbd
辜: bddzbabaebbd
辞: ebddzbabaebbd
辟: zbedzbabaebbd
辣: abaebbebdzbdec
辨: abaebbeaeabaebbd
辩: abaebbeakabaebbd
辫: abaebbe33fabaebbd
辰: bebbjec
辱: bebbjecbma
边: uea6c
辽: hma6c
达: beaa6c
迁: ebda6c
迂: bbma6c
迄: ebwa6c
迅: wbda6c
过: bmaa6c
迈: buea6c
迎: ejuda6c
运: bb3aa6c
近: eebda6c
迓: b3mea6c
返: eehaa6c
迕: ebbda6c
还: bedaa6c
这: abeaa6c
进: bbeda6c
远: bbena6c
违: bbuda6c
连: b3bda6c
迟: zbeaa6c
迢: uedzba6c
迤: ebudna6c
迥: dudzba6c
迦: uedzba6c
迨: 3adzba6c
迩: ehmeaa6c
迪: dzbdba6c
迫: edzbba6c
迭: ebbeaa6c
迮: ebdbba6c
述: bdeaaa6c
迷: aebdeaa6c
迸: aebbeda6c
迹: abemeaa6c
追: edzbzba6c
退: zbbjeaa6c
送: aebbeaa6c
适: ebddzba6c
逃: eafneaa6c
逄: ehcb3da6c
逅: eebdzba6c
逆: aeb2dea6c
选: ebdbena6c
逊: hmfmeaa6c
逋: bdubbdaa6c
逍: daedubba6c
透: ebdec7ea6c
逐: beleeeaa6c
逑: bmafeaaa6c
递: aezbxdea6c
途: ecbbmeaa6c
逖: eleaeeaa6c
逗: bdzbaeba6c
通: hadubbda6c
逛: elebbdba6c
逝: bmfeebda6c
逞: dzbbbdba6c
速: bdzbdeaa6c
造: ebdbdzba6c
逡: 3aeaehaa6c
逢: ehcbbbda6c
逦: bduaduaa6c
逭: aahdzbzba6c
逮: zbbmafeaa6c
逯: zbbmafeaa6c
逵: bdbeabdba6c
逶: ebdeaieba6c
逸: ehdzbenaa6c
逻: dzddbehaa6c
逼: bdzbdzbdba6c
逾: ecbdubbdma6c
遁: eebddzbbba6c
遂: aebeleeeaa6c
遄: d2dbedudda6c
遇: dzbbdudfaa6c
遍: azbedubdda6c
遏: dzbbeuea2a6c
遐: zbdbbzbhaa6c
遑: edzbbbbdba6c
遒: aebdze2bba6c
道: aebedzbbba6c
遗: dzbdbdzeaa6c
遘: bbddbdudbba6c
遛: ejauedzbdba6c
遢: dzbbuafuafa6c
遣: dzbdbdzbzba6c
遥: eaaeebbd2da6c
遨: bbdbueebeaa6c
遭: bdzbddbdzbba6c
遮: abebddbaaaaa6c
遴: aebdeaehab3da6c
遵: aebdze2bbbmaa6c
遽: dbhebnbeleeeaa6c
避: zbedzbabaebbda6c
邀: edzbbabueebeaa6c
邂: eheubbdueebbda6c
邃: aaheaaebeleeeaa6c
邈: eaaeleeedzbbena6c
邋: iiidzeabjaajaaoa6c
邑: dzbzdbn
邓: hard
邕: iiidzbzdbn
邗: bbdrd
邙: ab2rd
邛: bdfrd
邝: aberd
邡: abuerd
邢: bbedrd
那: ubberd
邦: bbberd
邪: b3merd
邬: euxfrd
邮: dzbdbrd
邯: bddbbrd
邰: 3adzbrd
邱: edbdfrd
邳: bedafrd
邴: bdueard
邵: uedzbrd
邶: dbfbjrd
邸: ejboard
邹: ehzbbrd
邺: ddaefrd
邻: eaahard
邽: bdbbdfrd
邾: ebbdeard
郁: bedubbrd
郄: eabe3a7d
郅: b3abdfrd
郇: eudzbbrd
郈: eebdzbrd
郊: abeaeard
郎: azbbjard
郏: baebeard
郐: eabb3ard
郑: aebbeard
郓: ahb3dfrd
郗: eabedudrd
郚: bdzbdzbrd
郛: eaaehmfrd
郜: ebdbdzbrd
郝: bdbemeard
郡: zbbedzbrd
郢: dzbbbdfrd
郤: eaeadzbrd
郦: bduaduard
郧: dzbdzeard
部: abaebdzbrd
郫: edzbbebdrd
郭: abdzbhmfrd
郯: aeeaaeeard
郴: bdeabdeard
郸: aedzbbbdrd
都: bdbedzbbrd
郾: bdzbbieb2rd
郿: zdbedzbbbrd
鄂: dzbdzbbbxrd
鄄: bdzddbbdfrd
鄌: abezbbddzb7d
鄘: abezbbdubbdrd
鄙: dzbbddzdzbbrd
鄞: bddbdzbbbdfrd
鄢: bdbdbbxaaaard
鄣: abaebdzbbbdrd
鄯: aebbbdaebdzbrd
鄱: eaebdeadzbdbrd
鄹: bddbbfhaedeeeard
酃: bahdaaaadzbdzbdzbrd
酆: dbbbdbbbd2dbdzbaefrd
酉: bdze2bb
酊: bdze2bbbm
酋: aebdze2bb
酌: bdze2bbeua
配: bdze2bbzbn
酎: bdze2bbbma
酏: bdze2bbudn
酐: bdze2bbbbd
酒: aafbdze2bb
酗: bdze2bbea2d
酚: bdze2bbecue
酝: bdze2bbbb3a
酞: bdze2bbbeca
酡: bdze2bbaahen
酢: bdze2bbebdbb
酣: bdze2bbbddbb
酤: bdze2bbbddzb
酥: bdze2bbebdec
酦: bdze2bb3ehca
酩: bdze2bbehadzb
酪: bdze2bbehcdzb
酬: bdze2bbaeadad
酮: bdze2bbdubdzb
酯: bdze2bbendzbb
酰: bdze2bbebdben
酱: afdehabdze2bb
酲: bdze2bbdzbbbdb
酴: bdze2bbecbbmea
酵: bdze2bbbdbehmb
酶: bdze2bbeb2uaba
酷: bdze2bbebdbdzb
酸: bdze2bb3aeaehc
酹: bdze2bbeaaebma
酽: bdze2bbbddaebe
酾: bdze2bbbduadua
酿: bdze2bbazbbjec
醅: bdze2bbabaebdzb
醇: bdze2bbabdzbhmb
醉: bdze2bbabeaeabd
醋: bdze2bbbddbdzbb
醌: bdze2bbdzbbbjen
醍: bdze2bbdzbbbdbec
醐: bdze2bbbddzbeubb
醑: bdze2bbhdbecdubb
醒: bdze2bbdzbbebbdb
醚: bdze2bbaebdeaa6c
醛: bdze2bbbddecbbdb
醢: bdze2bbbedzbdzddb
醪: bdze2bbzafzafeceee
醭: bdze2bbddaebaebbbec
醮: bdze2bbedabbbdbaaaa
醯: bdze2bbab3aedndzddb
醴: bdze2bbdzbddbbdzbaeb
醵: bdze2bbdbhebnbeleeec
醺: bdze2bbebdzaebdbbaaaa
醾: bdze2bbabebdeabdeaaebdec
采: eaaebdec
釉: eaebdeadzbdb
释: eaebdeahcbbd
里: dzbbdbb
重: ebdzbbdbb
野: dzbbdbfhahm
量: dzbbbdzbbdbb
金: ecbbdaeb
釜: eaecbbdaeb
鉴: ddebaecbbdaeb
銎: bdfewaecbbdaeb
銮: abddeaecbbdaeb
鋆: bdfeuafecbbdaeb
鋈: aafebeaecbbdaeb
錾: b3dfeebdecbbdaeb
鍪: hahmeebeaecbbdaeb
鎏: aafab3aednecbbdaeb
鏊: bbdbueebeaecbbdaeb
鏖: abezddbbjenecbbdaeb
鐾: zbedzbabaebbdecbbdaeb
鑫: ecbbdaebecbbdaefecbbdaeb
钆: ebbbjn
钇: ebbbjw
针: ebbbjbd
钉: ebbbjbm
钊: ebbbjdm
钋: ebbbjda
钌: ebbbjhm
钍: ebbbjbdb
钎: ebbbjebd
钏: ebbbjedd
钐: ebbbjeee
钒: ebbbjewa
钓: ebbbjeua
钔: ebbbjadu
钕: ebbbjieb
钗: ebbbjhca
钘: ebbbjbbed
钙: ebbbjbdbx
钚: ebbbjbeda
钛: ebbbjbeca
钝: ebbbjb2dn
钞: ebbbjdeae
钟: ebbbjdzbd
钠: ebbbjduea
钡: ebbbjdzea
钢: ebbbjduea
钣: ebbbjeehc
钤: ebbbjecah
钥: ebbbjeubb
钦: ebbbjehec
钧: ebbbjeuaf
钨: ebbbjeuxb
钩: ebbbjeu3a
钪: ebbbjabew
钫: ebbbjabue
钬: ebbbjaeec
钭: ebbbjaabd
钮: ebbbjzdbb
钯: ebbbjzdbn
钰: ebbbjbbdba
钱: ebbbjbboea
钲: ebbbjbdbdb
钳: ebbbjbddbb
钴: ebbbjbddzb
钵: ebbbjbdecb
钷: ebbbjbdzb2
钹: ebbbjbehca
钺: ebbbjbjoea
钻: ebbbjdbdzb
钼: ebbbjdzbbb
钽: ebbbjdzbbb
钾: ebbbjdzbbd
钿: ebbbjdzbdb
铀: ebbbjdzbdb
铁: ebbbjebbec
铂: ebbbjedzbb
铃: ebbbjecaha
铄: ebbbje2mea
铅: ebbbjeqdzb
铆: ebbbjejeud
铈: ebbbjabdud
铉: ebbbjab33a
铊: ebbbjaahen
铋: ebbbjaoaea
铌: ebbbjzbeen
铍: ebbbjhedhc
铎: ebbbjhcbbd
铐: ebbbjbdbebx
铑: ebbbjbdbeen
铒: ebbbjbddbbb
铕: ebbbjbedubb
铗: ebbbjbaebec
铘: ebbbjb3me7d
铙: ebbbjboeben
铚: ebbbjb3abdb
铛: ebbbjdaezbb
铜: ebbbjdubdzb
铝: ebbbjdzbdzb
铞: ebbbjdzbdud
铟: ebbbjdzbeab
铠: ebbbjd2dzbn
铡: ebbbjdzeadm
铢: ebbbjebbdec
铣: ebbbjebdben
铤: ebbbjebdb6c
铥: ebbbjebdb3a
铧: ebbbjedenbd
铨: ebbbjecbbdb
铩: ebbbjeabmea
铪: ebbbjecbdzb
铫: ebbbjeafnea
铬: ebbbjehcdzb
铭: ebbbjehadzb
铮: ebbbjehzbbm
铯: ebbbjehzdbn
铰: ebbbjabeaec
铱: ebbbjabejec
铲: ebbbjabaebe
铳: ebbbjab3aen
铴: ebbbjaafree
铵: ebbbjaahieb
银: ebbbjzbbjec
铷: ebbbjiebdzb
铸: ebbbjbbbebma
铹: ebbbjbddahue
铺: ebbbjbdubbda
铻: ebbbjbdzbdzb
铼: ebbbjbaebdec
铽: ebbbjbaoaaoa
链: ebbbjb3bda6c
铿: ebbbjddhcbdb
销: ebbbjdaedubb
锁: ebbbjdaedzea
锂: ebbbjdzbbdbb
锃: ebbbjdzbbbdb
锄: ebbbjdzbbfue
锅: ebbbjdzbduea
锆: ebbbjebdbdzb
锇: ebbbjebmfoea
锈: ebbbjebdec7e
锉: ebbbjeaeabdb
锊: ebbbjeaaebma
锋: ebbbjehcbbbd
锌: ebbbjabaebbd
锎: ebbbjadubbed
锏: ebbbjadudzbb
锐: ebbbjaedzben
锑: ebbbjaezbxde
锒: ebbbjazbbjec
锓: ebbbjzbbahhc
锔: ebbbjzbeudzb
锕: ebbbjrdbdzbm
锖: ebbbjbbdbdubb
锗: ebbbjbdbedzbb
锘: ebbbjbddbedzb
错: ebbbjbddbdzbb
锚: ebbbjbdddzbdb
锛: ebbbjbecbdbed
锜: ebbbjbeabdzbm
锝: ebbbjdzbbbbma
锞: ebbbjdzbbbdec
锟: ebbbjdzbbbjen
锡: ebbbjdzbbeuee
锢: ebbbjdzbddzbb
锣: ebbbjdzddbeha
锤: ebbbjebdbddbb
锥: ebbbjedabbbdb
锦: ebbbjedzbbdud
锧: ebbbjeebddzea
锨: ebbbjeebdehec
锩: ebbbjaebbecun
锪: ebbbjeueeaoaa
锫: ebbbjabaebdzb
锬: ebbbjaeeaaeec
锭: ebbbjaahbdbec
键: ebbbjzbbbbd6c
锯: ebbbjzbebddzb
锰: ebbbjhmbdzddb
锱: ebbbjiiidzbdb
锲: ebbbjbbbduebec
锴: ebbbjbjenedzbb
锵: ebbbjafdehabma
锶: ebbbjdzbdbaoaa
锷: ebbbjdzbdzbbbx
锸: ebbbjebdedbzbb
锹: ebbbjebdeaaeec
锻: ebbbjedbbfeqhc
锽: ebbbjedzbbbbdb
锾: ebbbjeaaebbehc
锿: ebbbjabdzbejec
镀: ebbbjabebddbhc
镁: ebbbjaebbdbbec
镂: ebbbjaebdecieb
镃: ebbbjaeb33a33a
镄: ebbbjzbxeddzea
镅: ebbbjzdbedzbbb
镆: ebbbjbdddzbbbec
镇: ebbbjbddzbbbbea
镈: ebbbjbdzbbdabma
镉: ebbbjbdzbduaebd
镊: ebbbjbddbbbhahc
镋: ebbbjdaeahdzben
镌: ebbbjedabbbdbre
镍: ebbbjedzbbbbdec
镎: ebbbjecbdzbebbm
镏: ebbbjejauedzbdb
镐: ebbbjabdzbdudzb
镑: ebbbjabaeahabue
镒: ebbbjaebeadzddb
镓: ebbbjaahbeleeec
镔: ebbbjaahedbdbea
镖: ebbbjbdzddbbbmea
镗: ebbbjdaeahdzbbdb
镘: ebbbjdzbbdzddbhc
镚: ebbbjd2deubbeubb
镛: ebbbjabezbbdubbd
镜: ebbbjabaebdzbben
镝: ebbbjabaedubddzb
镞: ebbbjabueebebbec
镠: ebbbjzafzafeceee
镡: ebbbjbdzddbdzbbbd
镢: ebbbjbeaeb2deehec
镣: ebbbjbecaedzbbmea
镤: ebbbjddaebaebbbec
镥: ebbbjehdzbdbbdzbb
镦: ebbbjabdzbhmfebec
镧: ebbbjadubdzaebdea
镨: ebbbjaebddaebdzbb
镩: ebbbjaaheadzbdzbd
镪: ebbbjzbxdzbdzbdba
镫: ebbbjhaeecbdzbaeb
镬: ebbbjbddedabbbdbhc
镭: ebbbjbahdaaaadzbdb
镯: ebbbjdzddbeudzbdba
镰: ebbbjabeaebzbbddec
镱: ebbbjabaebdzbbaoaa
镲: ebbbjaahehaahcbbmea
镳: ebbbjabezddbbjenaaaa
镴: ebbbjiiidzeabjaajaao
镵: ebbbjehdzbbjenehdzbena
镶: ebbbjabdzbdzbbbddbejec
长: ebjc
门: adu
闩: adub
闪: aduea
闭: adubme
问: adudzb
闯: aduzxb
闰: adubbdb
闱: adubbud
闲: adubdea
闳: adube3a
间: adudzbb
闵: aduabea
闶: aduabew
闷: aduaoaa
闸: adudzbbd
闹: aduabdud
闺: adubdbbdb
闻: adubddbbb
闼: adubeaa6c
闽: adudzbdba
闾: adudzbdzb
闿: adud2dzbn
阀: aduedboea
阁: aduehcdzb
阂: aduab3eea
阃: adudzbdeab
阄: aduehdzbbn
阅: aduaedzben
阆: aduazbbjea
阇: adubdbedzbb
阈: adubdzbfoea
阉: adubecdzbbn
阊: adudzbbdzbb
阋: aduedbzbben
阌: adueaaeahha
阍: aduejbodzbb
阎: aduehedbzbb
阏: aduabueecaa
阐: aduaedzbbbd
阑: adubdzaebdea
阒: adudzbbbbeaa
阔: aduaafebddzb
阕: aduhaeecbbea
阖: adubdb3adzddb
阗: adubddzbbbbea
阘: adudzbbuafuaf
阙: aduaeb2deehea
阚: aduhbddbbfebea
阜: edzbzbbd
队: rdec
阡: rdebd
阢: rdben
阪: rdeehc
阮: rdbben
阱: rdbbed
防: rdabue
阳: rddzbb
阴: rdeubb
阵: rdb3bd
阶: rdeced
阻: rddzbbb
阼: rdebdbb
阽: rddbdzb
阿: rdbdzbm
陀: rdaahen
陂: rdhedhc
附: rdedbma
际: rdbbmea
陆: rdbbd2d
陇: rdbenea
陈: rdb3mea
陉: rdhabdb
陋: rdbduea2
陌: rdbedzbb
降: rdehcb3d
限: rdzbbjec
陔: rdab3eea
陕: rdbaebec
陛: rdbjenbdb
陟: rddbdbdee
陡: rdbdbdbec
院: rdaahbben
除: rdecbbmea
陧: rddzbbbdb
陨: rddzbdzea
险: rdecbaaeb
陪: rdabaebdzb
陬: rdbddbbfhc
陲: rdebdbddbb
陴: rdedzbbebd
陵: rdbdbeaehc
陶: rdeuebbd2d
陷: rdehedbzbb
隅: rddzbbdudfa
隆: rdehcbebbdb
隈: rddzbdbbjec
隋: rdbebdbdubb
隍: rdedzbbbbdb
随: rdbedubba6c
隐: rdehzbbaoaa
隔: rdbdzbduaebd
隗: rdedzbben3a
隘: rdaebeadzddb
隙: rddeadzbbmea
障: rdabaebdzbbbd
隧: rdaebeleeeaa6c
隰: rddzbb33a33aaaaa
隳: rdbebdbdubbecmaaa
隶: zbbmafec
隼: edabbbdbbd
隽: edabbbdbre
难: haedabbbdb
雀: deaedabbbdb
雁: beededabbbdb
雄: be3aedabbbdb
雅: b3meedabbbdb
集: edabbbdbbdec
雇: azbeedabbbdb
雉: ebbeaedabbbdb
雌: dbdfbjedabbbdb
雍: ab33eedabbbdb
雎: dzbbfedabbbdb
雏: ehzbbedabbbdb
雒: ehadzbedabbbdb
雕: eubdbdzbedabbbdb
雠: edabbbdbakedabbbdb
雨: bdudaaaa
雩: bahdaaaabbx
雪: bahdaaaazbb
雯: bahdaaaaabec
雳: bahdaaaabeue
零: bahdaaaaecaha
雷: bahdaaaadzbdb
雹: bahdaaaaeuzbn
雾: bahdaaaaehcue
需: bahdaaaabedudd
霁: bahdaaaaabeced
霄: bahdaaaadaedubb
霆: bahdaaaaebdb6c
震: bahdaaaabebbjec
霈: bahdaaaaaafbdud
霉: bahdaaaaeb2uaba
霍: bahdaaaaedabbbdb
霎: bahdaaaaabaebieb
霏: bahdaaaadbbbdbbb
霓: bahdaaaaedbzbben
霖: bahdaaaabdeabdec
霜: bahdaaaabdeadzbbb
霞: bahdaaaazbdbbzbhc
霪: bahdaaaaaafeaaeebdb
霭: bahdaaaaakdzbbeuea2
霰: bahdaaaabddbdubbebec
露: bahdaaaadzbdbdfehcdzb
霸: bahdaaaabddbdzbbdeubb
霹: bahdaaaazbedzbabaebbd
霾: bahdaaaaeaaeleedzbbdbb
青: bbdbdubb
靓: bbdbdubbdzen
靖: abaefbbdbdubb
静: bbdbdubbehzbbm
靛: bbdbdubbaahbdbec
非: dbbbdbbb
靠: ebdbdzbdbbbdbbb
靡: abebdeabdecdbbbdbbb
面: bedzddbbb
靥: bebecabedzddbbb
革: bddbdzbbd
靰: bddbdzbbdben
靳: bddbdzbbdeebd
靴: bddbdzbbdeden
靶: bddbdzbbdzdbn
靸: bddbdzbbde6c
靺: bddbdzbbdbbdec
靼: bddbdzbbddzbbb
靽: bddbdzbbdaebbd
靿: bddbdzbbd33aue
鞁: bddbdzbbdhedhc
鞅: bddbdzbbddzbec
鞋: bddbdzbbdbdbbdb
鞍: bddbdzbbdaahieb
鞑: bddbdzbbdbeaa6c
鞒: bddbdzbbdebeced
鞘: bddbdzbbddaedubb
鞠: bddbdzbbdeuaebdea
鞡: bddbdzbbdbmfabaeb
鞣: bddbdzbbdhahmebdec
鞧: bddbdzbbdaebdze2bb
鞨: bddbdzbbddzbbeuea2
鞫: bddbdzbbdeuabbbdzb
鞭: bddbdzbbdedbdzbbec
鞯: bddbdzbbdbddbedhmb
鞲: bddbdzbbdbbddbdudbb
鞴: bddbdzbbdbddbedubbd
韂: bddbdzbbdehbeeaabbbdzb
韦: bbud
韧: bbuduea
韨: bbudbehca
韩: bddzbbbdbbud
韪: dzbbbdbecbbud
韫: bbuddzbbdzddb
韬: bbudeaaeedbzbb
韭: dbbbdbbbb
音: abaebdzbb
韵: abaebdzbbeuaf
韶: abaebdzbbuedzb
页: bedzea
顶: bmbedzea
顷: bjbedzea
顸: bbdbedzea
项: bdfbedzea
顺: eddbedzea
须: eeebedzea
顼: bbdfbedzea
顽: bbejbedzea
顾: beujbedzea
顿: b2djbedzea
颀: eebdbedzea
颁: eauebedzea
颂: ea3abedzea
颃: abekbedzea
预: hahmbedzea
颅: dbzbebedzea
领: eaahabedzea
颇: hedhabedzea
颈: habdfbedzea
颉: bdbdzbbedzea
颊: baebeabedzea
颋: ebdb6cbedzea
颌: eabdzbbedzea
颍: enmheabedzea
颏: ab3eeabedzea
颐: bddzbd2bedzea
频: dbdbdeebedzea
颓: ebdeaekbedzea
颔: eaahdzbbedzea
颖: enebdeabedzea
颗: dzbbbdeabedzea
题: dzbbbdbecbedzea
颙: dzbbdudfabedzea
颚: dzbdzbbbxbedzea
颛: d2dbeduddbedzea
颜: abaebeeeebedzea
额: aahehadzbbedzea
颞: bddbbbhahabedzea
颟: bddbdueaeabedzea
颠: bddzbbbbeabedzea
颡: hahahabdeabedzea
颢: dzbbabdzbmeabedzea
颤: abdzdzbbdzbbfbedzea
颥: bahdaaaabeduddbedzea
颦: dbdbdeebedzeaedzbbebd
颧: bdddzbdzbedabbbdbbedzea
风: ewea
飐: eweadbdzb
飑: eweaeuzbn
飒: abaefewea
飓: eweadzbbbbea
飔: eweadzbdbaoaa
飕: eweaedbzbbdha
飗: eweaejauedzbdb
飘: bdzddbbbmeaewea
飙: beaabeaabeaaewea
飞: wea
食: ecazbbjea
飧: ehaecazbbjec
飨: 33eecazbbjea
餍: bebeaaecazbbjea
餐: dbehahaecazbbjea
餮: behaeceeeecazbbjea
饔: ab33eedabbbdbecazbbjea
饕: dzbbxdbhebnewecazbbjea
饥: ehjew
饧: ehjree
饨: ehjb2dn
饩: ehjebbw
饪: ehjebdb
饫: ehjebec
饬: ehjebue
饭: ehjeehc
饮: ehjehec
饯: ehjbboea
饰: ehjebdud
饱: ehjeuzbn
饲: ehjubdzb
饳: ehj2dd2d
饴: ehj3adzb
饵: ehjbddbbb
饶: ehjboeben
饷: ehjedudzb
饸: ehjecbdzb
饹: ehjehcdzb
饺: ehjabeaec
饻: ehjabejec
饼: ehjaebbed
饽: ehjbdahhmb
饿: ehjebmfoea
馀: ehjecbbmea
馁: ehjeaaeieb
馃: ehjdzbbbdec
馄: ehjdzbbbjen
馅: ehjehedbzbb
馆: ehjaahdzbzb
馇: ehjbdecdzbbb
馈: ehjdzbdbdzea
馉: ehjdzzahdubb
馊: ehjedbzbbdhc
馋: ehjehdzbenaa
馌: ehjbdb3adzddb
馍: ehjbdddzbbbec
馏: ehjejauedzbdb
馐: ehjaebbbezdbb
馑: ehjbddbdzbbbdb
馒: ehjdzbbdzddbhc
馓: ehjbddbdubbebec
馔: ehjzbjzbnbddbea
馕: ehjbdzbdahdzbdzbbbddbejec
首: aebedzbbb
馗: ewaebedzbbb
馘: aebedzbbbbdzbfoea
香: ebdecdzbb
馥: ebdeadzbbebdzbbehc
馨: bdbzdbeeqhaebdecdzbb
马: zxb
驭: zxfhc
驮: zxfbec
驯: zxfedd
驰: zxfudn
驱: zxfbea2
驳: zxfeaec
驴: zxfazbe
驵: zxfdzbbb
驶: zxfdzbec
驷: zxfdze2b
驸: zxfedbma
驹: zxfeudzb
驺: zxfehzbb
驻: zxfabbdb
驼: zxfaahen
驽: iebhczxb
驾: uedzbzxb
驿: zxfhcbbd
骀: zxf3adzb
骁: zxfboeben
骂: dzbdzbzxb
骄: zxfebeced
骅: zxfedenbd
骆: zxfehcdzb
骇: zxfab3eea
骈: zxfaebbed
骊: zxfbduadua
骋: zxfdzbdbbx
验: zxfecbaaeb
骍: zxfabaebbd
骎: zxfzbbahhc
骏: zxf3aeaehc
骐: zxfbddbbbea
骑: zxfbeabdzbm
骒: zxfdzbbbdec
骓: zxfedabbbdb
骖: zxf3abeceee
骗: zxfazbedubdd
骘: rddbdbdeezxb
骙: zxfhaeecbbea
骚: zxfhcadzbdba
骛: hahmeebeczxb
骜: bbdbueebeczxb
骝: zxfejauedzbdb
骞: aahbbddbeczxb
骟: zxfazbeuafuaf
骠: zxfbdzddbbbmea
骡: zxfdzbdb33amea
骢: zxfedzehabaoaa
骣: zxfzbehmbhmfhmb
骤: zxfbddbbfhaedeeec
骥: zxfdbfendzbdbbddbea
骧: zxfabdzbdzbbbddbejec
骨: dzzahdubb
骰: dzzahdubbeqhc
骶: dzzahdubbejboa
骷: dzzahdubbbddzb
骸: dzzahdubbab3eea
骺: dzzahdubbeebdzb
骼: dzzahdubbehcdzb
髀: dzzahdubbedzbbebd
髁: dzzahdubbdzbbbdec
髂: dzzahdubbaahehcdzb
髅: dzzahdubbaebdecieb
髋: dzzahdubbaahbdddzen
髌: dzzahdubbaahedbdbea
髑: dzzahdubbdzddbeudzbdba
髓: dzzahdubbbebdbdubba6c
高: abdzbdudzb
髡: bdbbb3aeeeben
髦: bdbbb3aeeeebbn
髫: bdbbb3aeeeuedzb
髭: bdbbb3aeeedbdfen
髯: bdbbb3aeeedudbb
髹: bdbbb3aeeeedbdec
髻: bdbbb3aeeebdbdzb
鬃: bdbbb3aeeeaahbbmea
鬈: bdbbb3aeeeaebbecun
鬏: bdbbb3aeeeebdeaaeec
鬓: bdbbb3aeeeaahedbdbea
鬟: bdbbb3aeeedzddbbdzbejec
鬣: bdbbb3aeeeiiidzeabjaajaao
鬯: eaaaaa2den
鬲: bdzbduaebd
鬶: bbeadzenbdzbduaebd
鬻: zbxaebdeazbxbdzbduaebd
鬼: edzbben3a
魁: edzbben3aaabd
魂: bb3aedzbben3a
魃: edzbben3abehaa
魄: edzbbedzbben3a
魅: edzbben3abbdec
魆: edzbben3abjoea
魇: bebecaedzbben3a
魈: edzbben3adaedubb
魉: edzbben3abdueaea
魍: edzbben3aduaebab2
魏: ebdeaiebedzbben3a
魑: edzbben3aabea2ddu3a
魔: abebdeabdecedzbben3a
鱼: ehdzbdbb
鱽: ehdzbdbfue
鱾: ehdzbdbfzbn
鱿: ehdzbdbfbena
鲀: ehdzbdbfb2dn
鲁: ehdzbdbbdzbb
鲂: ehdzbdbfabue
鲃: ehdzbdbfzdbn
鲅: ehdzbdbfbehca
鲆: ehdzbdbfbaebd
鲇: ehdzbdbfdbdzb
鲈: ehdzbdbfdbzbe
鲉: ehdzbdbfdzbdb
鲊: ehdzbdbfebdbb
鲋: ehdzbdbfedbma
鲌: ehdzbdbfedzbb
鲍: ehdzbdbfeuzbn
鲎: aaeahehdzbdbb
鲏: ehdzbdbfhedhc
鲐: ehdzbdbf3adzb
鲑: ehdzbdbfbdbbdb
鲔: ehdzbdbfbedubb
鲙: ehdzbdbfecbb3a
鲚: ehdzbdbfabeced
鲛: ehdzbdbfabeaec
鲜: ehdzbdbfaebbbd
鲞: aebbecehdzbdbb
鲟: ehdzbdbfzbbbma
鲠: ehdzbdbfbdzbbec
鲡: ehdzbdbfbduadua
鲢: ehdzbdbfb3bda6c
鲣: ehdzbdbfddhcbdb
鲤: ehdzbdbfdzbbdbb
鲥: ehdzbdbfdzbbbma
鲦: ehdzbdbfehcbmea
鲧: ehdzbdbfe33amea
鲨: aafdeaeehdzbdbb
鲩: ehdzbdbfaahbben
鲪: ehdzbdbfzbbedzb
鲫: ehdzbdbfzbbjaud
鲬: ehdzbdbfhadubbd
鲭: ehdzbdbfbbdbdubb
鲮: ehdzbdbfbdbeaehc
鲯: ehdzbdbfbddbbbea
鲰: ehdzbdbfbddbbfhc
鲱: ehdzbdbfdbbbdbbb
鲲: ehdzbdbfdzbbbjen
鲳: ehdzbdbfdzbbdzbb
鲴: ehdzbdbfdzbddzbb
鲵: ehdzbdbfedbzbben
鲷: ehdzbdbfeubdbdzb
鲸: ehdzbdbfabdzbmea
鲹: ehdzbdbf3abeceee
鲺: ehdzbdbfwbdzbdba
鲻: ehdzbdbfiiidzbdb
鲼: ehdzbdbfbdbdddzea
鲽: ehdzbdbfbddb2bdec
鲾: ehdzbdbfbdzbdzbdb
鳀: ehdzbdbfdzbbbdbec
鳁: ehdzbdbfdzbbdzddb
鳂: ehdzbdbfdzbdbbjec
鳃: ehdzbdbfdzbdbaoaa
鳄: ehdzbdbfdzbdzbbbx
鳅: ehdzbdbfebdeaaeec
鳆: ehdzbdbfebdzbbehc
鳇: ehdzbdbfedzbbbbdb
鳈: ehdzbdbfedzbbmhec
鳉: ehdzbdbfafdehabma
鳊: ehdzbdbfazbedubdd
鳌: bbdbueebecehdzbdbb
鳍: ehdzbdbfbdbeendzbb
鳎: ehdzbdbfdzbbuafuaf
鳏: ehdzbdbfdzddbdeeaa
鳐: ehdzbdbfeaaeebbd2d
鳑: ehdzbdbfabaeahabue
鳓: ehdzbdbfbddbdzbbdue
鳔: ehdzbdbfbdzddbbbmea
鳕: ehdzbdbfbahdaaaazbb
鳖: aedudeaebecehdzbdbb
鳗: ehdzbdbfdzbbdzddbhc
鳘: eb2zabaebecehdzbdbb
鳙: ehdzbdbfabezbbdubbd
鳚: ehdzbdbfzbebbmeabma
鳜: ehdzbdbfbeaeb2deehec
鳝: ehdzbdbfaebbbdaebdzb
鳞: ehdzbdbfaebdecehab3d
鳟: ehdzbdbfaebdze2bbbma
鳡: ehdzbdbfbebdzboeaaoaa
鳢: ehdzbdbfdzbddbbdzbaeb
鳤: ehdzbdbfebaebaaahdzbzb
鸟: euaxb
鸠: eweuaxb
鸡: haeuaxb
鸢: boaeuaxb
鸣: dzbeuaxb
鸤: zbeeuaxb
鸥: bea2euaxb
鸦: b3meeuaxb
鸨: enbdeuaxb
鸩: ahejeuaxb
鸪: bddzbeuaxb
鸫: b3meaeuaxb
鸬: dbzbeeuaxb
鸭: dzbbdeuaxb
鸮: dzbbxeuaxb
鸯: dzbeceuaxb
鸰: eaahaeuaxb
鸱: ejboaeuaxb
鸲: eudzbeuaxb
鸳: ehauneuaxb
鸵: euaxfaahen
鸶: 3333beuaxb
鸷: bmfewaeuaxb
鸸: beduddeuaxb
鸹: ebddzbeuaxb
鸺: edbdeaeuaxb
鸻: eedbbmeuaxb
鸼: eeuabaeuaxb
鸽: eabdzbeuaxb
鸾: abddeaeuaxb
鸿: aafbdfeuaxb
鹀: bdeaeafeuaxb
鹁: bdahhmfeuaxb
鹂: bduaduaeuaxb
鹃: dzbdubbeuaxb
鹄: ebdbdzbeuaxb
鹅: ebmfoeaeuaxb
鹆: eaeadzbeuaxb
鹇: adubdeaeuaxb
鹈: aezbxdeeuaxb
鹉: bbdbdfoaeuaxb
鹊: bddbdzbbeuaxb
鹋: bdddzbdbeuaxb
鹌: beadzbbjeuaxb
鹎: edzbbebdeuaxb
鹏: eubbeubbeuaxb
鹐: ehedbzbbeuaxb
鹑: abdzbhmfeuaxb
鹕: bddzbeubbeuaxb
鹗: dzbdzbbbxeuaxb
鹘: dzzahdubbeuaxb
鹚: aeb33a33aeuaxb
鹛: zdbedzbbbeuaxb
鹜: hahmeebeceuaxb
鹝: bdzbduaebdeuaxb
鹞: eaaeebbd2deuaxb
鹟: ea3auafuafeuaxb
鹠: ejauedzbdbeuaxb
鹡: afeaeadubbeuaxb
鹣: aebzbbddeaeuaxb
鹤: ahedabbbdbeuaxb
鹦: dzeadzeaiebeuaxb
鹧: abebddbaaaaeuaxb
鹨: zafzafeaeeeeuaxb
鹩: becaedzbbmeaeuaxb
鹪: edabbbdbaaaaeuaxb
鹫: abdzbmeabenaeuaxb
鹬: hahmedueadzbeuaxb
鹭: dzbdbdfehcdzbeuaxb
鹮: dzddbbdzbejeaeuaxb
鹰: abeededabbbdbeuaxb
鹱: euaxfbddedabbbdbhc
鹲: bddahbbeleeeaeuaxb
鹳: bdddzbdzbedabbbdbeuaxb
鹿: abezddbbjen
麂: abezddbbjenew
麇: abezddbbjenebdec
麈: abezddbbjenabbdb
麋: abezddbbjenaebdec
麒: abezddbbjbjbddbbbea
麓: bdeabdecabezddbbjen
麝: abezddbbjenedubbbebma
麟: abezddbbjbjaebdecehab3d
麦: bbdbehc
麸: bbdbehabbec
麻: abebdeabdec
麽: abebdeabdece3a
麾: abebdeabdecebbn
黄: bddbdzbdbea
黇: bddbdzbdbeadbdzb
黉: aaeahbddbdzbdbea
黍: ebdeaecmafea
黎: ebdeaeueecmafea
黏: ebdeaeamafaadbdzb
黑: dzaebdbbaaaa
黔: dzaebdbfaaaaecah
默: dzaebdbfaaaabeca
黛: edboadzaebdbbaaaa
黜: dzaebdbfaaaa2dd2d
黝: dzaebdbfaaaa33aue
黟: dzaebdbfaaaaehaeha
黠: dzaebdbfaaaabdbdzb
黢: dzaebdbfaaaa3aeaehc
黥: dzaebdbfaaaaabdzbmea
黧: ebdeaeuedzaebdbbaaaa
黩: dzaebdbfaaaabdhaabea
黯: dzaebdbfaaaaabaebdzbb
黹: ddaebaedudea
黻: ddaebaedudeabehca
黼: ddaebaedudeabdubbda
黾: dzbdzbbn
鼋: bbendzbdzbbn
鼍: dzbdzbdzbdbbdzbdzbbn
鼎: dzbbb5bedbdz
鼐: redzbbb5bedbdz
鼒: bmedzbbb5bedbdz
鼓: bdbdzbaefbdhc
鼗: eafneabdbdzbaefbdhc
鼙: bdbdzbaefbdhcedzbbebd
鼠: edbzbbjaajaao
鼢: edbzbbjaajaaoecue
鼩: edbzbbjaajaaoeudzb
鼫: edbzbbjaajaaobedzb
鼬: edbzbbjaajaaodzbdb
鼯: edbzbbjaajaaobdzbdzb
鼱: edbzbbjaajaaobbdbdubb
鼷: edbzbbjaajaaoeaae33abec
鼹: edbzbbjaajaaodzbbaahieb
鼻: edzbbbdzbdbbed
鼾: edzbbbdzbdbbedbbd
齁: edzbbbdzbdbbedeudzb
齉: edzbbbdzbdbbedbdzbdahdzbdzbbbddbejec
齐: abeced
齑: abeceddbbbdbbbb
齿: dbdbea2d
龀: dbdbea2den
龁: dbdbea2debw
龃: dbdbea2ddzbbb
龄: dbdbea2decaha
龅: dbdbea2deuzbn
龆: dbdbea2duedzb
龇: dbdbea2ddbdfen
龈: dbdbea2dzbbjec
龉: dbdbea2dbdzbdzb
龊: dbdbea2ddzbdbec
龋: dbdbea2dedzbdudfa
龌: dbdbea2dzbeb3abdb
龙: benea
龚: beneabddbea
龛: ecbdzbbenea
龟: ehdzbbn
龠: ecbdzbdzbdzbdubdd